"","Player","Min","Tkl_Tackles","TklW_Tackles","Def 3rd_Tackles","Mid 3rd_Tackles","Att 3rd_Tackles","Tkl_Vs_Dribbles","Att_Vs_Dribbles","Tkl_percent_Vs_Dribbles","Past_Vs_Dribbles","Blocks_Blocks","Sh_Blocks","Pass_Blocks","Int","Tkl+Int","Clr","Err"
"1","Aaron Cresswell",1240,13,6,7,6,0,6,16,NA,10,13,7,6,14,27,33,0
"2","Aaron Hickey",679,20,14,12,8,0,8,14,NA,6,9,4,5,10,30,11,0
"3","Aarón Martín",1241,30,21,17,9,4,15,18,NA,3,12,1,11,11,41,17,0
"4","Aaron Mooy",423,8,5,4,3,1,6,9,NA,3,6,4,2,4,12,10,0
"5","Aaron Ramsdale",1260,1,1,1,0,0,1,1,NA,0,0,0,0,0,1,7,2
"6","Aaron Ramsey",844,18,9,7,9,2,6,14,NA,8,12,2,10,9,27,11,0
"7","Aaron Wan-Bissaka",5,0,0,0,0,0,0,0,NA,0,0,0,0,0,0,2,0
"8","Abakar Sylla",402,5,1,5,0,0,3,3,NA,0,7,5,2,4,9,15,1
"9","Abdallah Sima",555,6,1,0,5,1,0,4,NA,4,1,0,1,2,8,6,0
"10","Abdelhamid Sabiri",873,14,5,5,5,4,3,11,NA,8,16,2,14,5,19,3,0
"11","Abdelkarim Hassan",270,7,3,5,2,0,3,4,NA,1,3,1,2,1,8,5,0
"12","Abderrazak Hamdallah",28,0,0,0,0,0,0,0,NA,0,0,0,0,0,0,1,0
"13","Abdessamad Ezzalzouli",338,12,9,5,6,1,5,5,NA,0,8,0,8,2,14,2,0
"14","Abdón Prats",137,1,0,1,0,0,0,0,NA,0,1,0,1,0,1,2,0
"15","Abdou Diallo",904,12,9,9,3,0,4,7,NA,3,6,5,1,9,21,29,0
"16","Abdou Harroui",271,6,0,3,1,2,1,6,NA,5,3,1,2,0,6,2,0
"17","Abdoul Kader Bamba",78,0,0,0,0,0,0,2,NA,2,3,1,2,0,0,1,0
"18","Abdoulaye Bamba",375,12,5,7,4,1,8,8,NA,0,3,0,3,7,19,7,0
"19","Abdoulaye Doucouré",186,6,4,1,5,0,1,3,NA,2,2,0,2,0,6,2,0
"20","Abdoulaye Seck",397,7,7,6,0,1,5,7,NA,2,9,5,4,4,11,18,0
"21","Abdu Conté",466,12,9,5,4,3,8,13,NA,5,4,2,2,1,13,7,0
"22","Abdul Fatawu Issahaku",89,4,3,3,1,0,0,0,NA,0,1,0,1,0,4,2,0
"23","Abdul Mumin",102,0,0,0,0,0,0,0,NA,0,1,1,0,1,1,2,0
"24","Abdulaziz Hatem",196,1,1,0,0,1,1,2,NA,1,0,0,0,1,2,0,0
"25","Abdulelah Al-Amri",182,1,0,1,0,0,0,1,NA,1,1,1,0,4,5,9,0
"26","Abdulellah Al-Malki",174,3,1,3,0,0,1,3,50,2,3,0,3,2,5,4,1
"27","Abdullah Madu",45,1,0,1,0,0,0,0,NA,0,3,2,1,1,2,1,0
"28","Abdulrahman Al-Aboud",35,3,3,2,1,0,1,5,NA,4,0,0,0,0,3,0,0
"29","Abolfazl Jalali",19,0,0,0,0,0,0,0,NA,0,0,0,0,0,0,1,0
"30","Achraf Dari",721,11,9,9,2,0,8,11,NA,3,9,5,4,11,22,27,2
"31","Achraf Hakimi",1678,44,26,21,13,10,24,41,NA,17,20,1,19,12,56,13,0
"32","Adam Armstrong",869,8,4,3,3,2,0,4,NA,4,13,3,10,2,10,4,0
"33","Adam Buksa",63,1,0,0,0,1,0,0,NA,0,0,0,0,0,1,0,0
"34","Adam Forshaw",50,0,0,0,0,0,0,3,NA,3,3,0,3,0,0,0,0
"35","Adam Hložek",851,8,4,6,1,1,2,5,NA,3,8,1,7,2,10,11,0
"36","Adam Kronus",3,0,0,0,0,0,0,0,NA,0,0,0,0,0,0,0,0
"37","Adam Lallana",489,8,4,5,2,1,0,5,NA,5,4,0,4,2,10,1,0
"38","Adam Marušić",1061,9,7,5,2,2,3,9,NA,6,2,1,1,12,21,23,0
"39","Adam Masina",304,4,3,2,2,0,2,3,NA,1,2,2,0,7,11,12,1
"40","Adam Ounas",678,9,5,3,4,2,3,7,NA,4,8,0,8,4,13,3,0
"41","Adam Smith",1305,29,17,17,9,3,18,32,NA,14,19,7,12,12,41,38,0
"42","Adam Vlkanova",458,5,2,2,2,1,2,5,NA,3,3,2,1,2,7,5,0
"43","Adam Webster",1170,10,7,6,3,1,5,8,NA,3,16,8,8,13,23,37,2
"44","Adama Soumaoro",602,12,7,5,5,2,2,2,NA,0,5,3,2,8,20,26,0
"45","Adama Traoré",622,6,2,1,3,2,1,3,NA,2,6,1,5,0,6,4,0
"46","Ademola Lookman",778,3,1,0,2,1,0,3,NA,3,6,0,6,1,4,0,0
"47","Adil Aouchiche",43,0,0,0,0,0,0,3,NA,3,0,0,0,0,0,0,0
"48","Adil Rami",539,9,7,6,2,1,8,14,NA,6,2,1,1,9,18,20,1
"49","Adnan Januzaj",99,2,1,1,1,0,1,2,NA,1,0,0,0,2,4,1,0
"50","Ado Onaiwu",288,5,3,0,2,3,2,3,NA,1,1,0,1,0,5,1,0
"51","Adri Embarba",458,17,7,5,11,1,5,10,NA,5,8,0,8,3,20,3,0
"52","Adrian Grbić",25,0,0,0,0,0,0,1,NA,1,3,0,3,0,0,0,0
"53","Adrien Hunou",1088,24,13,13,8,3,7,18,NA,11,15,0,15,0,24,4,0
"54","Adrien Rabiot",1406,37,20,15,15,7,13,20,NA,7,32,5,27,19,56,8,0
"55","Adrien Tameze",881,15,8,8,4,3,8,14,NA,6,16,6,10,7,22,16,0
"56","Adrien Thomasson",757,17,7,8,4,5,9,25,NA,16,15,0,15,2,19,2,0
"57","Adrien Truffert",1115,34,18,20,8,6,18,25,NA,7,22,6,16,17,51,32,0
"58","Agustín Álvarez Martínez",151,2,2,0,2,0,0,0,NA,0,2,1,1,2,4,1,0
"59","Agustín Marchesín",1260,0,0,0,0,0,0,1,NA,1,0,0,0,0,0,5,0
"60","Agustín Rogel",675,9,6,6,3,0,5,5,NA,0,8,2,6,9,18,28,0
"61","Ahmad Nourollahi",223,4,3,1,1,2,1,2,NA,1,3,0,3,6,10,8,0
"62","Ahmed Alaaeldin",6,0,0,0,0,0,0,0,NA,0,0,0,0,0,0,0,0
"63","Aihen Muñoz",666,17,9,10,5,2,10,17,NA,7,12,3,9,3,20,10,0
"64","Aimar Oroz",774,9,5,2,2,5,0,3,NA,3,9,0,9,11,20,5,0
"65","Aimen Dahmen",270,0,0,0,0,0,0,0,NA,0,0,0,0,0,0,2,0
"66","Ainsley Maitland-Niles",412,11,5,3,7,1,4,7,NA,3,9,1,8,3,14,7,0
"67","Aïssa Laïdouni",243,3,3,3,0,0,1,2,NA,1,7,1,6,4,7,6,0
"68","Aïssa Mandi",261,4,3,3,1,0,1,1,NA,0,3,3,0,7,11,8,0
"69","Aitor Fernández",360,0,0,0,0,0,0,0,NA,0,0,0,0,0,0,2,0
"70","Aitor Paredes",23,2,1,2,0,0,2,3,NA,1,0,0,0,2,4,0,0
"71","Aitor Ruibal",563,17,8,15,1,1,10,18,NA,8,4,0,4,13,30,14,0
"72","Ajdin Hrustic",250,2,1,1,1,0,1,2,NA,1,1,0,1,1,3,3,1
"73","Akim Zedadka",309,1,1,1,0,0,0,2,NA,2,3,0,3,1,2,5,0
"74","Akram Afif",270,0,0,0,0,0,0,1,NA,1,0,0,0,0,0,0,0
"75","Alan Franco",46,1,0,0,1,0,0,1,NA,1,0,0,0,2,3,1,0
"76","Alan Virginius",66,1,0,1,0,0,0,0,NA,0,0,0,0,1,2,0,0
"77","Alassane Pléa",825,6,2,2,3,1,2,9,NA,7,10,1,9,9,15,10,0
"78","Alban Lafont",1169,0,0,0,0,0,0,1,NA,1,0,0,0,0,0,8,1
"79","Albert Sambi Lokonga",198,1,1,0,0,1,0,2,NA,2,1,0,1,5,6,2,0
"80","Alberto Del Moral",5,0,0,0,0,0,0,0,NA,0,0,0,0,0,0,0,0
"81","Alberto Grassi",306,12,9,8,4,0,6,6,NA,0,5,4,1,11,23,10,0
"82","Alberto Moreno",368,7,2,1,5,1,4,12,NA,8,5,1,4,7,14,7,0
"83","Alberto Perea",45,2,0,2,0,0,0,0,NA,0,2,0,2,0,2,0,0
"84","Albin Ekdal",406,8,6,4,4,0,4,11,NA,7,4,0,4,4,12,6,0
"85","Aleix García",1245,19,7,3,10,6,5,11,NA,6,13,4,9,17,36,12,0
"86","Aleix Vidal",446,4,2,2,1,1,0,7,NA,7,11,1,10,4,8,4,0
"87","Alejandro Alfaro",15,0,0,0,0,0,0,0,NA,0,0,0,0,0,0,0,0
"88","Alejandro Balde",1175,19,15,11,6,2,8,13,NA,5,14,1,13,6,25,8,0
"89","Alejandro Garnacho",84,2,1,0,0,2,1,1,NA,0,0,0,0,0,2,0,0
"90","Alejandro Pozo Pozo",580,9,5,4,4,1,7,12,NA,5,9,4,5,11,20,13,1
"91","Alejandro Revuelta Montero",1,0,0,0,0,0,0,0,NA,0,0,0,0,0,0,1,0
"92","Aleksa Terzić",262,7,3,4,2,1,5,8,NA,3,6,2,4,3,10,4,0
"93","Aleksandar Mitrović",1189,10,4,4,3,3,4,7,NA,3,9,3,6,1,11,12,1
"94","Aleksandr Golovin",963,23,14,7,12,4,13,31,NA,18,12,0,12,13,36,4,0
"95","Aleksei Miranchuk",503,3,0,0,3,0,0,1,NA,1,0,0,0,0,3,1,0
"96","Aleš Čermák",32,2,1,0,1,1,0,0,NA,0,1,0,1,2,4,0,0
"97","Alessandro Bastoni",1124,17,10,9,6,2,7,10,NA,3,15,7,8,14,31,23,0
"98","Alessandro Buongiorno",754,8,3,7,1,0,3,5,NA,2,12,6,6,21,29,29,0
"99","Alessandro Cortinovis",6,1,0,1,0,0,0,0,NA,0,1,0,1,0,1,0,0
"100","Alessandro Florenzi",97,3,2,2,0,1,2,3,NA,1,0,0,0,1,4,1,0
"101","Alessandro Tuia",180,2,0,1,1,0,0,1,NA,1,1,0,1,4,6,5,0
"102","Alessandro Zanoli",24,3,2,2,1,0,1,1,NA,0,0,0,0,1,4,1,0
"103","Alessio Romagnoli",924,14,7,7,7,0,3,8,NA,5,12,10,2,12,26,36,0
"104","Alessio Zerbin",110,5,2,1,2,2,1,3,NA,2,4,1,3,0,5,2,0
"105","Alex Baena",630,11,4,5,2,4,6,10,NA,4,5,2,3,2,13,10,0
"106","Álex Berenguer",1026,25,14,8,8,9,11,21,NA,10,13,1,12,2,27,5,0
"107","Álex Collado",514,21,11,11,8,2,6,10,NA,4,9,1,8,1,22,3,0
"108","Álex Fernández",699,5,2,3,1,1,2,5,NA,3,7,1,6,4,9,8,0
"109","Alex Ferrari",803,9,5,7,2,0,4,6,NA,2,19,9,10,17,26,20,0
"110","Álex Grimaldo",540,20,9,10,4,6,13,22,358.4,9,7,3,4,9,29,10,0
"111","Alex Iwobi",1332,29,14,16,12,1,11,20,NA,9,12,1,11,9,38,15,0
"112","Alex Král",904,19,11,6,13,0,9,15,NA,6,20,3,17,11,30,23,0
"113","Alex Meret",1710,0,0,0,0,0,0,0,NA,0,0,0,0,0,0,4,2
"114","Álex Moreno",1170,22,15,17,5,0,15,30,NA,15,15,4,11,15,37,29,0
"115","Alex Oxlade-Chamberlain",32,0,0,0,0,0,0,1,NA,1,0,0,0,0,0,0,0
"116","Álex Remiro",1260,0,0,0,0,0,0,0,NA,0,0,0,0,0,0,8,2
"117","Alex Sandro",1093,24,11,13,10,1,7,7,NA,0,11,4,7,17,41,30,0
"118","Alex Sola",275,16,8,12,3,1,7,10,NA,3,5,0,5,3,19,10,0
"119","Alex Telles",1149,18,10,9,4,5,11,19,NA,8,13,3,10,11,29,19,1
"120","Alexander Bah",548,14,11,8,5,1,5,10,NA,5,13,3,10,15,29,9,0
"121","Alexander Djiku",1276,30,19,20,10,0,14,24,NA,10,20,8,12,29,59,61,3
"122","Alexander Hack",988,25,14,18,7,0,17,27,NA,10,13,5,8,20,45,39,0
"123","Alexander Isak",394,5,3,0,3,2,1,2,NA,1,3,0,3,1,6,3,0
"124","Alexander lowry",8,0,0,0,0,0,0,0,NA,0,0,0,0,0,0,0,0
"125","Alexander Meyer",675,0,0,0,0,0,0,1,NA,1,0,0,0,0,0,1,0
"126","Alexander Mighten",8,0,0,0,0,0,0,1,0,1,0,0,0,0,0,0,0
"127","Alexander Nübel",1350,0,0,0,0,0,0,1,NA,1,0,0,0,1,1,3,1
"128","Alexander Schwolow",1350,0,0,0,0,0,0,0,NA,0,0,0,0,1,1,3,2
"129","Alexander Sørloth",826,3,3,0,1,2,1,4,NA,3,4,1,3,0,3,9,1
"130","Alexandre Coeff",586,10,5,6,4,0,4,9,NA,5,9,4,5,8,18,35,1
"131","Alexandre Lacazette",1297,23,14,6,8,9,7,21,NA,14,5,0,5,9,32,3,0
"132","Alexandro Bernabei",11,0,0,0,0,0,0,0,NA,0,1,0,1,0,0,1,0
"133","Alexis Beka Beka",276,9,4,4,5,0,2,9,NA,7,5,1,4,7,16,1,0
"134","Alexis Blin",600,17,10,5,9,3,11,19,NA,8,17,8,9,8,25,26,0
"135","Alexis Claude-Maurice",283,9,6,4,4,1,5,8,NA,3,3,0,3,3,12,2,0
"136","Alexis Flips",642,16,9,9,6,1,9,21,400,12,12,2,10,14,30,9,0
"137","Alexis Mac Allister",1407,49,29,15,30,4,26,46,1115.4,20,14,1,13,21,70,5,1
"138","Alexis Saelemaekers",403,11,7,4,5,2,7,12,NA,5,4,1,3,3,14,3,0
"139","Alexis Sánchez",1272,14,10,3,9,2,0,4,NA,4,7,0,7,1,15,2,0
"140","Alexis Vega",193,0,0,0,0,0,0,0,NA,0,1,0,1,1,1,2,0
"141","Alexsandro Ribeiro",303,9,7,5,4,0,5,6,NA,1,1,0,1,4,13,11,0
"142","Alfonso Espino",1142,33,23,22,7,4,20,41,NA,21,25,5,20,12,45,29,0
"143","Alfonso Pedraza",805,17,16,8,7,2,11,14,NA,3,7,1,6,5,22,14,0
"144","Alfred Duncan",221,4,1,0,4,0,4,7,NA,3,2,0,2,3,7,2,0
"145","Alfredo Morelos",256,1,1,0,1,0,0,3,NA,3,4,0,4,1,2,3,0
"146","Ali Abdi",188,8,5,5,2,1,3,3,NA,0,1,0,1,4,12,12,1
"147","Ali Al-Bulaihi",216,4,2,2,2,0,2,4,NA,2,1,1,0,3,7,1,0
"148","Ali Al Hassan",45,2,1,0,2,0,1,1,100,0,2,1,1,0,2,1,0
"149","Ali Assadalla",27,0,0,0,0,0,0,0,NA,0,1,0,1,0,0,0,0
"150","Ali Gholizadeh",199,0,0,0,0,0,0,2,NA,2,5,0,5,3,3,2,0
"151","Ali Karimi",99,3,3,3,0,0,1,1,NA,0,0,0,0,3,6,1,0
"152","Ali Maâloul",90,1,1,0,1,0,1,1,100,0,2,0,2,0,1,5,0
"153","Ali Mohamed",356,11,2,7,2,2,3,11,NA,8,1,0,1,7,18,3,0
"154","Alidu Seidu",1278,21,13,13,6,2,13,23,NA,10,17,11,6,25,46,30,1
"155","Alireza Beiranvand",109,0,0,0,0,0,0,0,NA,0,0,0,0,0,0,2,0
"156","Alireza Jahanbakhsh",59,1,1,0,1,0,0,1,NA,1,2,0,2,1,2,0,0
"157","Alisson",1980,0,0,0,0,0,0,1,NA,1,1,0,1,0,0,8,0
"158","Alistair Johnston",180,4,2,4,0,0,1,6,25,5,2,0,2,1,5,3,0
"159","Allan McGregor",450,0,0,0,0,0,0,0,NA,0,0,0,0,0,0,2,0
"160","Allan Saint-Maximin",378,0,0,0,0,0,0,3,NA,3,0,0,0,4,4,0,0
"161","Almamy Touré",163,5,4,2,3,0,3,5,NA,2,5,2,3,5,10,2,0
"162","Almoez Ali",224,1,0,0,0,1,0,2,NA,2,0,0,0,1,2,1,0
"163","Alphonse Areola",107,0,0,0,0,0,0,0,NA,0,0,0,0,0,0,0,0
"164","Alphonso Davies",1542,36,20,18,13,5,13,22,NA,9,25,3,22,22,58,15,1
"165","Álvaro Aguado",747,3,1,2,1,0,3,7,NA,4,9,3,6,5,8,5,0
"166","Álvaro Fernández",360,0,0,0,0,0,0,0,NA,0,0,0,0,0,0,4,2
"167","Álvaro García",1095,19,9,8,4,7,3,6,NA,3,14,1,13,7,26,9,0
"168","Álvaro Giménez",17,0,0,0,0,0,0,1,0,1,0,0,0,0,0,0,0
"169","Álvaro Morata",1210,9,6,4,3,2,2,5,NA,3,7,4,3,0,9,14,0
"170","Álvaro Negredo",410,4,4,1,1,2,1,1,NA,0,4,1,3,0,4,5,0
"171","Alvaro Sanz",14,0,0,0,0,0,0,0,NA,0,1,1,0,0,0,0,0
"172","Álvaro Zamora",30,2,0,0,1,1,1,1,100,0,0,0,0,1,3,0,0
"173","Amadou Haidara",736,15,9,5,9,1,4,10,NA,6,13,2,11,13,28,11,0
"174","Amadou Onana",1139,41,27,15,22,4,16,22,NA,6,11,2,9,10,51,21,0
"175","Amar Dedić",540,19,11,13,5,1,10,12,NA,2,5,1,4,9,28,19,1
"176","Amath",243,7,4,4,0,3,2,2,NA,0,1,0,1,0,7,1,0
"177","Amine Adli",476,8,5,2,3,3,1,6,NA,5,16,0,16,2,10,1,0
"178","Amine Gouiri",1014,11,4,3,3,5,1,8,NA,7,7,0,7,3,14,7,0
"179","Amine Harit",895,7,4,0,4,3,4,9,NA,5,7,2,5,7,14,7,0
"180","Amine Salama",532,3,3,0,2,1,0,4,NA,4,6,2,4,2,5,2,0
"181","Amir Rrahmani",981,16,8,12,4,0,6,9,NA,3,23,12,11,3,19,45,1
"182","Amos Pieper",1102,24,15,14,9,1,10,15,NA,5,16,8,8,17,41,57,0
"183","Anatolii Trubin",540,0,0,0,0,0,0,1,NA,1,0,0,0,0,0,1,1
"184","Ander Barrenetxea",62,4,3,4,0,0,2,5,NA,3,2,0,2,1,5,1,0
"185","Ander Capa",1,0,0,0,0,0,0,0,NA,0,0,0,0,0,0,0,0
"186","Ander Guevara",126,1,0,0,1,0,0,1,NA,1,2,1,1,1,2,2,0
"187","Ander Herrera",238,3,1,2,1,0,2,3,NA,1,5,1,4,4,7,5,0
"188","Andoni Gorosabel",713,19,7,11,3,5,12,16,NA,4,6,0,6,7,26,6,0
"189","András Schäfer",702,19,8,7,11,1,6,12,NA,6,9,1,8,4,23,11,0
"190","Andre-Frank Zambo Anguissa",1493,35,15,13,13,9,8,18,NA,10,22,2,20,28,63,16,0
"191","André Ayew",153,1,1,0,1,0,0,1,NA,1,1,0,1,0,1,3,0
"192","André Gomes",536,15,6,4,6,5,7,20,NA,13,8,3,5,3,18,9,1
"193","André Hahn",391,9,5,4,4,1,8,12,NA,4,9,2,7,4,13,14,0
"194","André Onana",1160,0,0,0,0,0,0,0,NA,0,0,0,0,0,0,2,0
"195","André Silva",1218,11,3,2,5,4,3,4,NA,1,9,1,8,2,13,2,0
"196","Andrea Barberis",316,6,2,4,2,0,4,9,NA,5,0,0,0,8,14,1,0
"197","Andrea Belotti",316,4,2,0,1,3,2,3,NA,1,3,1,2,1,5,1,0
"198","Andrea Cambiaso",772,25,16,17,7,1,7,20,NA,13,10,1,9,9,34,11,1
"199","Andrea Carboni",155,2,2,1,0,1,1,4,NA,3,3,2,1,2,4,2,1
"200","Andrea Colpani",264,4,3,2,1,1,3,5,NA,2,3,0,3,3,7,0,0
"201","Andrea Consigli",1260,1,0,1,0,0,0,0,NA,0,0,0,0,0,1,4,0
"202","Andrea Conti",23,0,0,0,0,0,0,0,NA,0,0,0,0,0,0,0,0
"203","Andrea Petagna",351,2,2,1,0,1,1,1,NA,0,2,2,0,1,3,4,0
"204","Andrea Pinamonti",1067,4,3,0,2,2,1,3,NA,2,10,1,9,1,5,5,0
"205","Andrea Ranocchia",47,3,1,1,2,0,3,4,75,1,5,5,0,0,3,7,0
"206","Andreas Bruus",506,4,1,3,1,0,3,4,NA,1,4,1,3,5,9,4,0
"207","Andreas Christensen",804,13,6,6,6,1,4,4,NA,0,10,7,3,10,23,21,0
"208","Andreas Cornelius",201,1,1,0,1,0,0,0,NA,0,3,0,3,0,1,2,0
"209","Andreas Pereira",1240,10,5,1,4,5,5,11,NA,6,13,2,11,4,14,3,0
"210","Andreas Skov Olsen",427,4,2,1,2,1,2,3,NA,1,5,1,4,0,4,3,0
"211","Andreas Ulmer",375,7,1,2,3,2,3,9,NA,6,3,0,3,4,11,13,0
"212","Andrei Girotto",1152,47,27,31,14,2,26,47,NA,21,21,8,13,37,84,70,1
"213","Andrej Kramarić",1168,4,1,1,1,2,1,5,NA,4,7,1,6,1,5,6,0
"214","Andrés Guardado",344,14,7,5,9,0,6,14,NA,8,3,2,1,6,20,5,0
"215","Andrew Gravillon",1032,15,8,9,5,1,8,13,NA,5,18,9,9,21,36,35,0
"216","Andrew Robertson",1060,5,3,2,3,0,3,11,NA,8,9,2,7,5,10,19,0
"217","Andrey Lunyov",90,0,0,0,0,0,0,0,NA,0,0,0,0,0,0,0,0
"218","Andries Noppert",270,0,0,0,0,0,0,0,NA,0,0,0,0,0,0,1,0
"219","Andrija Živković",133,3,2,2,1,0,2,3,NA,1,2,0,2,2,5,1,0
"220","Andriy Lunin",540,0,0,0,0,0,0,0,NA,0,0,0,0,0,0,1,0
"221","Andriy Totovytskyi",17,0,0,0,0,0,0,0,NA,0,0,0,0,0,0,1,0
"222","Andy Delort",746,2,0,1,1,0,1,2,NA,1,0,0,0,1,3,7,0
"223","Ángel Algobia",362,15,6,10,5,0,11,14,NA,3,7,3,4,1,16,2,0
"224","Ángel Correa",828,7,2,2,3,2,5,10,NA,5,12,2,10,7,14,4,1
"225","Ángel Di María",577,7,3,3,1,3,2,6,NA,4,4,0,4,1,8,0,0
"226","Angel Gomes",1013,16,7,6,5,5,6,14,NA,8,6,1,5,5,21,4,0
"227","Ángel Rodríguez",149,0,0,0,0,0,0,0,NA,0,0,0,0,0,0,1,0
"228","Angeliño",1174,13,6,3,8,2,5,8,NA,3,12,3,9,9,22,24,0
"229","Angelo Fulgini",493,6,5,2,3,1,5,10,NA,5,4,0,4,5,11,6,0
"230","Angelo Ogbonna",27,1,0,1,0,0,0,0,NA,0,2,0,2,0,1,1,0
"231","Ángelo Preciado",264,7,5,3,3,1,2,4,NA,2,2,0,2,6,13,4,0
"232","Angelo Stiller",241,11,7,1,8,2,4,5,NA,1,2,0,2,3,14,2,0
"233","Anis Ben Slimane",148,3,1,2,1,0,0,0,NA,0,2,0,2,1,4,1,0
"234","Ansgar Knauff",848,21,14,14,6,1,6,14,NA,8,14,2,12,14,35,16,0
"235","Ansu Fati",713,6,6,2,2,2,3,7,NA,4,8,0,8,3,9,3,0
"236","Ante Budimir",554,2,1,0,2,0,0,3,NA,3,3,0,3,2,4,5,0
"237","Ante Palaversa",10,1,1,1,0,0,0,0,NA,0,0,0,0,1,2,0,0
"238","Ante Rebić",598,9,4,2,4,3,2,8,NA,6,4,0,4,1,10,1,0
"239","Anthony Caci",620,19,10,10,9,0,10,12,NA,2,3,1,2,22,41,10,0
"240","Anthony Contreras",124,5,2,3,2,0,1,1,NA,0,0,0,0,1,6,0,0
"241","Anthony Elanga",369,2,0,0,2,0,1,2,NA,1,4,0,4,1,3,3,0
"242","Anthony Gordon",983,28,18,15,10,3,6,18,NA,12,17,0,17,2,30,10,0
"243","Anthony Jung",1142,25,17,10,10,5,18,25,NA,7,10,2,8,8,33,29,0
"244","Anthony Lopes",1016,0,0,0,0,0,0,0,NA,0,0,0,0,1,1,5,0
"245","Anthony Losilla",1329,37,27,21,12,4,18,29,NA,11,16,5,11,21,58,26,0
"246","Anthony Lozano",756,1,1,0,1,0,0,2,NA,2,4,1,3,2,3,11,0
"247","Anthony Martial",201,0,0,0,0,0,0,1,NA,1,1,0,1,0,0,1,0
"248","Anthony Modeste",1036,4,4,2,0,2,2,7,NA,5,9,2,7,2,6,23,0
"249","Anthony Rouault",1342,25,19,19,6,0,14,28,NA,14,25,12,13,27,52,57,1
"250","Antoine Griezmann",1376,31,21,11,14,6,10,21,NA,11,18,3,15,12,43,7,0
"251","Antoine Mendy",12,0,0,0,0,0,0,0,NA,0,0,0,0,1,1,0,0
"252","Antoine Semenyo",1,0,0,0,0,0,0,0,NA,0,0,0,0,0,0,0,0
"253","Anton Stach",1011,12,11,7,5,0,7,12,NA,5,15,1,14,20,32,10,0
"254","Antonee Robinson",1378,25,15,20,5,0,15,22,NA,7,25,7,18,14,39,44,1
"255","Antonín Barák",721,9,5,3,2,4,2,6,NA,4,4,1,3,2,11,7,0
"256","Antonin Bobichon",18,0,0,0,0,0,0,0,NA,0,1,0,1,0,0,0,0
"257","Antonino Gallo",825,16,8,11,2,3,11,16,NA,5,11,2,9,7,23,24,0
"258","Antonio Adán",382,0,0,0,0,0,0,0,NA,0,0,0,0,0,0,4,1
"259","Antonio Candreva",1008,6,2,6,0,0,4,17,NA,13,4,1,3,11,17,14,0
"260","Antonio Čolak",284,0,0,0,0,0,0,3,NA,3,0,0,0,1,1,2,0
"261","Antonio Marin",7,0,0,0,0,0,0,0,NA,0,0,0,0,0,0,0,0
"262","Antonio Nusa",41,0,0,0,0,0,0,0,NA,0,1,0,1,0,0,2,0
"263","Antonio Raillo",1170,10,5,10,0,0,2,5,NA,3,11,7,4,15,25,65,0
"264","Antonio Rüdiger",1181,9,7,4,5,0,4,5,NA,1,11,6,5,8,17,35,0
"265","Antonio Sanabria",679,3,2,0,1,2,0,1,NA,1,2,1,1,3,6,3,0
"266","Antonio Sánchez",580,6,3,4,1,1,3,13,NA,10,7,0,7,8,14,3,0
"267","António Silva",537,9,6,8,1,0,5,8,350,3,9,3,6,11,20,25,0
"268","Antonios Papadopoulos",23,0,0,0,0,0,0,0,NA,0,0,0,0,1,1,0,0
"269","Antony",520,10,2,4,5,1,3,9,NA,6,8,0,8,3,13,1,0
"270","Anuar",210,4,4,0,1,3,0,0,NA,0,5,2,3,3,7,3,0
"271","Ao Tanaka",70,3,1,3,0,0,1,1,100,0,4,1,3,0,3,1,0
"272","Arber Zeneli",669,8,2,3,3,2,5,10,NA,5,5,0,5,1,9,1,0
"273","Ardian Ismajli",755,16,13,9,7,0,6,7,NA,1,23,15,8,12,28,45,0
"274","Arial Mendy",223,4,2,3,0,1,2,2,NA,0,2,0,2,4,8,4,0
"275","Aridane Hernández",144,1,1,1,0,0,0,1,NA,1,2,2,0,3,4,7,0
"276","Arijan Ademi",471,16,11,10,6,0,7,13,NA,6,5,3,2,3,19,3,0
"277","Aritz Elustondo",618,13,9,7,5,1,6,7,NA,1,6,5,1,9,22,18,1
"278","Arkadiusz Milik",1089,6,5,1,3,2,1,7,NA,6,6,0,6,1,7,8,0
"279","Arkadiusz Reca",754,17,9,7,6,4,5,9,NA,4,8,1,7,5,22,17,0
"280","Armand Lauriente",1014,13,10,3,7,3,5,9,NA,4,12,1,11,6,19,5,0
"281","Armando Broja",410,6,2,0,3,3,1,2,NA,1,11,2,9,1,7,1,0
"282","Armando Izzo",435,17,14,10,5,2,4,5,NA,1,5,1,4,10,27,17,0
"283","Armel Bella Kotchap",903,18,6,16,2,0,8,9,NA,1,16,5,11,26,44,54,0
"284","Arnau Martinez",811,17,10,13,2,2,11,20,NA,9,9,2,7,8,25,10,0
"285","Arnau Puigmal",241,2,1,0,1,1,1,2,NA,1,3,0,3,3,5,1,0
"286","Arnaud Kalimuendo",605,5,2,1,2,2,0,2,NA,2,9,1,8,1,6,2,0
"287","Arnaud Nordin",807,9,2,4,4,1,5,6,NA,1,7,0,7,4,13,2,0
"288","Arnaud Souquet",342,20,14,12,6,2,10,13,NA,3,7,3,4,4,24,4,0
"289","Arnaut Groeneveld",476,3,3,1,0,2,1,2,NA,1,0,0,0,0,3,1,1
"290","Arne Maier",528,9,5,4,4,1,3,5,NA,2,6,0,6,2,11,3,0
"291","Artem Bondarenko",484,14,4,10,2,2,5,9,NA,4,1,0,1,7,21,6,0
"292","Arthur",563,8,4,2,2,4,4,6,NA,2,5,0,5,0,8,4,0
"293","Arthur Melo",14,1,0,1,0,0,1,1,100,0,0,0,0,0,1,0,0
"294","Arthur Theate",1350,11,6,7,4,0,7,10,NA,3,11,6,5,11,22,43,0
"295","Artur Jędrzejczyk",19,0,0,0,0,0,0,0,NA,0,0,0,0,0,0,1,0
"296","Ashley Young",729,19,12,14,5,0,13,14,NA,1,10,3,7,10,29,21,0
"297","Asier Illarramendi",153,4,0,2,2,0,3,6,NA,3,3,1,2,7,11,5,0
"298","Asier Villalibre",92,0,0,0,0,0,0,0,NA,0,0,0,0,0,0,1,0
"299","Asiri Haitham",2,0,0,0,0,0,0,1,0,1,2,0,2,0,0,1,0
"300","Asmir Begović",90,0,0,0,0,0,0,0,NA,0,0,0,0,0,0,1,0
"301","Assan Ceesay",869,16,13,6,5,5,5,7,NA,2,9,1,8,1,17,17,0
"302","Assim Madibo",153,6,3,3,3,0,1,5,50,4,6,1,5,2,8,0,0
"303","Aster Vranckx",57,0,0,0,0,0,0,0,NA,0,1,0,1,0,0,1,0
"304","Atakan Karazor",486,22,10,8,11,3,8,12,NA,4,9,2,7,7,29,15,0
"305","Atiba Hutchinson",128,2,0,2,0,0,1,1,NA,0,3,0,3,0,2,2,0
"306","Augusto Solari",187,5,5,2,2,1,1,6,NA,5,4,0,4,3,8,0,0
"307","Aurélien Tchouaméni",1536,43,22,14,27,2,16,24,NA,8,16,3,13,32,75,24,0
"308","Awer Mabil",189,2,0,0,1,1,1,3,NA,2,2,1,1,1,3,1,0
"309","Axel Camblan",35,0,0,0,0,0,0,1,NA,1,0,0,0,0,0,0,0
"310","Axel Disasi",1440,24,16,11,9,4,12,19,NA,7,24,14,10,35,59,49,1
"311","Axel Gueguin",14,0,0,0,0,0,0,0,NA,0,1,0,1,0,0,0,0
"312","Axel Witsel",1709,22,12,12,10,0,10,15,NA,5,25,16,9,15,37,45,0
"313","Ayase Ueda",45,0,0,0,0,0,0,1,0,1,1,1,0,0,0,2,0
"314","Ayman Azhil",1,0,0,0,0,0,0,0,NA,0,0,0,0,0,0,0,0
"315","Aymen Barkok",83,5,1,4,1,0,2,2,NA,0,1,0,1,1,6,4,0
"316","Aymeric Laporte",733,4,1,4,0,0,1,2,NA,1,5,2,3,5,9,14,1
"317","Ayoze Pérez",148,5,4,3,1,1,2,4,NA,2,2,0,2,0,5,2,0
"318","Aziz Behich",270,7,3,5,2,0,5,6,200,1,5,2,3,2,9,12,0
"319","Azor Matusiwa",783,21,15,9,9,3,8,13,NA,5,9,3,6,20,41,20,0
"320","Azzedine Ounahi",1256,22,11,7,14,1,13,23,NA,10,9,0,9,17,39,4,1
"321","Baba Rahman",93,2,0,1,1,0,1,1,NA,0,0,0,0,1,3,3,1
"322","Bafodé Diakité",1075,19,10,7,10,2,7,16,NA,9,17,4,13,5,24,31,0
"323","Baila Diallo",34,0,0,0,0,0,0,0,NA,0,0,0,0,0,0,0,0
"324","Bailey Wright",17,0,0,0,0,0,0,0,NA,0,0,0,0,0,0,2,0
"325","Bamba Dieng",198,4,4,2,1,1,3,4,NA,1,6,1,5,0,4,0,0
"326","Banzouzi Locko",1056,32,16,22,4,6,16,27,NA,11,17,4,13,20,52,21,0
"327","Baptiste Santamaria",551,21,11,3,16,2,12,17,NA,5,5,2,3,6,27,4,0
"328","Bartłomiej Drągowski",1122,0,0,0,0,0,0,2,NA,2,0,0,0,0,0,7,1
"329","Bartol Franjić",215,4,2,2,2,0,0,1,NA,1,4,1,3,4,8,4,0
"330","Bartosz Bereszyński",1269,29,17,18,9,2,18,24,NA,6,19,4,15,18,47,32,0
"331","Bassam Al-Rawi",90,0,0,0,0,0,0,1,0,1,0,0,0,0,0,7,0
"332","Batista Mendy",1034,32,14,16,12,4,18,23,NA,5,18,4,14,8,40,13,0
"333","Bebé",60,0,0,0,0,0,0,2,NA,2,1,0,1,0,0,0,0
"334","Ben Chilwell",757,13,6,5,6,2,10,16,NA,6,6,2,4,8,21,10,0
"335","Ben Davies",1785,23,14,7,11,5,12,20,NA,8,21,11,10,19,42,60,2
"336","Ben Godfrey",17,1,1,1,0,0,0,0,NA,0,0,0,0,0,1,0,0
"337","Ben Johnson",488,10,6,7,1,2,6,8,NA,2,7,3,4,5,15,18,1
"338","Ben Mee",1208,14,8,8,6,0,8,14,NA,6,21,19,2,22,36,47,1
"339","Ben Pearson",214,6,2,2,3,1,0,1,NA,1,4,0,4,1,7,3,0
"340","Ben White",1150,28,14,10,14,4,21,30,NA,9,23,7,16,9,37,26,0
"341","Beñat Turrientes",106,4,3,4,0,0,1,4,NA,3,2,0,2,0,4,3,0
"342","Béni Makouana",105,1,0,0,1,0,0,2,NA,2,2,1,1,0,1,0,0
"343","Benjamin André",1126,59,33,21,31,7,27,51,782.1,24,18,5,13,17,76,25,0
"344","Benjamin Bourigeaud",1180,9,8,3,5,1,6,22,NA,16,16,0,16,13,22,13,0
"345","Benjamin Henrichs",1053,41,23,23,18,0,25,35,NA,10,24,3,21,18,59,21,0
"346","Benjamin Lecomte",899,0,0,0,0,0,0,0,NA,0,0,0,0,0,0,3,2
"347","Benjamin Leroy",1178,0,0,0,0,0,0,1,NA,1,0,0,0,0,0,4,0
"348","Benjamin Pavard",1442,41,27,23,15,3,17,19,NA,2,18,6,12,29,70,45,0
"349","Benjamin Šeško",330,3,1,0,1,2,1,1,NA,0,4,1,3,0,3,2,0
"350","Benjamin Tahirovic",22,0,0,0,0,0,0,1,0,1,0,0,0,1,1,0,0
"351","Benno Schmitz",1033,27,18,13,13,1,19,26,958.4,7,16,2,14,10,37,27,0
"352","Benoît Badiashile",839,10,8,6,4,0,5,10,NA,5,9,6,3,17,27,40,1
"353","Benoît Costil",1350,2,0,2,0,0,2,4,NA,2,0,0,0,0,2,4,0
"354","Berat Djimsiti",342,7,2,4,3,0,4,4,NA,0,3,1,2,6,13,9,0
"355","Bernardo",274,10,6,9,1,0,4,7,216.7,3,6,3,3,5,15,16,1
"356","Bernardo Espinosa",499,4,0,1,3,0,2,3,NA,1,7,3,4,3,7,20,2
"357","Bernardo Folha",8,1,1,1,0,0,0,0,NA,0,0,0,0,0,1,0,0
"358","Bernardo Silva",1526,27,13,8,15,4,14,27,NA,13,13,1,12,9,36,6,0
"359","Bernd Leno",1170,0,0,0,0,0,0,1,NA,1,0,0,0,0,0,6,0
"360","Beto",597,7,4,0,4,3,2,5,NA,3,5,0,5,1,8,8,0
"361","Bevic Moussiti-Oko",487,3,1,1,1,1,1,1,NA,0,3,1,2,1,4,7,0
"362","Bilal Brahimi",327,1,1,0,1,0,0,2,NA,2,1,0,1,2,3,0,0
"363","Billy Gilmour",16,0,0,0,0,0,0,1,NA,1,0,0,0,0,0,1,0
"364","Bingourou Kamara",408,0,0,0,0,0,0,0,NA,0,0,0,0,0,0,2,0
"365","Birama Touré",1333,35,18,15,16,4,16,39,NA,23,17,1,16,29,64,26,0
"366","Birger Meling",279,3,2,1,2,0,2,3,NA,1,2,1,1,5,8,8,0
"367","Bjorn Meijer",392,8,8,5,2,1,3,7,NA,4,6,2,4,7,15,9,0
"368","Blanco",158,6,4,5,1,0,4,6,233.3,2,5,0,5,1,7,3,0
"369","Bobby Clark",8,0,0,0,0,0,0,0,NA,0,2,0,2,0,0,0,0
"370","Bobby Reid",1211,23,15,8,9,6,8,16,NA,8,17,2,15,9,32,17,0
"371","Bohdan Mykhaylychenko",360,7,2,5,2,0,5,7,NA,2,3,0,3,7,14,16,0
"372","Bonke Innocent",613,13,6,9,3,1,7,18,NA,11,12,2,10,9,22,21,0
"373","Borja Iglesias",957,8,4,3,3,2,2,5,NA,3,3,1,2,0,8,6,0
"374","Borja Mayoral",1105,4,1,3,1,0,3,5,NA,2,4,0,4,0,4,3,0
"375","Borna Barišić",465,9,3,4,4,1,4,8,NA,4,11,7,4,3,12,5,0
"376","Borna Sosa",1057,21,12,14,5,2,17,24,NA,7,10,2,8,8,29,23,0
"377","Boualem Khoukhi",270,2,2,2,0,0,1,2,NA,1,6,2,4,3,5,18,1
"378","Boubacar Kamara",669,30,13,13,14,3,13,26,NA,13,15,5,10,4,34,15,0
"379","Boubacar Traoré",384,10,4,4,3,3,2,6,NA,4,4,2,2,7,17,1,0
"380","Boubakary Soumaré",668,30,21,12,16,2,15,22,NA,7,3,1,2,12,42,15,0
"381","Boulaye Dia",1096,7,2,2,3,2,0,3,NA,3,1,0,1,2,9,12,1
"382","Bradley Barcola",81,3,2,0,2,1,1,2,NA,1,2,0,2,1,4,1,0
"383","Brahim Díaz",694,9,5,3,3,3,1,2,NA,1,4,0,4,1,10,2,0
"384","Braian Cufré",194,5,2,2,1,2,2,4,150,2,2,1,1,1,6,0,0
"385","Brais Méndez",1121,31,18,9,16,6,15,27,NA,12,13,1,12,5,36,6,0
"386","Bram Nuytinck",373,7,4,3,4,0,4,8,NA,4,6,6,0,4,11,22,0
"387","Branco van den Boomen",1327,31,14,11,16,4,14,34,NA,20,10,2,8,5,36,15,0
"388","Brandon Aguilera",45,2,0,2,0,0,2,3,100,1,0,0,0,1,3,0,0
"389","Brandon Baiye",50,3,2,2,1,0,2,3,NA,1,1,0,1,1,4,3,0
"390","Brandon Mechele",540,7,5,3,4,0,2,6,NA,4,5,4,1,7,14,28,0
"391","Brandon Soppy",608,7,4,2,5,0,2,5,NA,3,12,0,12,3,10,8,0
"392","Brayann Pereira",180,6,5,5,1,0,1,5,33.3,4,2,2,0,2,8,8,1
"393","Brecht Dejaegere",767,14,9,2,7,5,3,20,NA,17,9,3,6,6,20,4,0
"394","Breel Embolo",1237,9,5,2,1,6,5,10,NA,5,9,1,8,5,14,10,0
"395","Brendan Chardonnet",1215,21,14,10,11,0,10,15,NA,5,18,6,12,30,51,34,0
"396","Brenden Aaronson",1273,26,8,9,14,3,8,24,NA,16,24,1,23,2,28,5,0
"397","Brennan Johnson",1278,8,7,3,2,3,3,7,NA,4,14,1,13,2,10,1,1
"398","Brian Brobbey",116,0,0,0,0,0,0,0,NA,0,0,0,0,0,0,0,0
"399","Brian Ocampo",560,8,7,4,3,1,6,10,NA,4,5,0,5,1,9,3,0
"400","Brian Oliván",1209,31,18,20,7,4,10,13,NA,3,8,2,6,14,45,33,0
"401","Brice Samba",1350,1,0,1,0,0,1,1,NA,0,0,0,0,0,1,6,0
"402","Bruno Amione",410,4,1,4,0,0,3,5,NA,2,5,0,5,8,12,10,0
"403","Bruno Fernandes",1349,28,16,8,13,7,7,17,NA,10,16,1,15,12,40,17,0
"404","Bruno Guimarães",1025,31,14,6,22,3,14,23,NA,9,15,3,12,15,46,9,1
"405","Bruno Petković",521,9,5,2,5,2,3,12,NA,9,2,0,2,2,11,6,0
"406","Bruno Xavier Almeida Costa",73,2,2,1,1,0,1,1,NA,0,0,0,0,1,3,0,0
"407","Bryan",47,1,1,1,0,0,0,2,NA,2,2,0,2,2,3,0,0
"408","Bryan Cristante",1103,43,18,21,17,5,21,30,871.7,9,21,6,15,5,48,19,0
"409","Bryan Mbeumo",1290,7,4,3,1,3,2,11,NA,9,9,0,9,3,10,6,0
"410","Bryan Oviedo",171,5,5,2,2,1,3,4,150,1,2,0,2,2,7,3,0
"411","Bryan Ruiz",30,1,1,0,1,0,1,1,100,0,1,1,0,0,1,0,0
"412","Bukayo Saka",1317,16,11,5,3,8,2,9,NA,7,18,1,17,10,26,10,0
"413","Cafú",7,0,0,0,0,0,0,0,NA,0,0,0,0,0,0,1,0
"414","Çağlar Söyüncü",71,2,1,1,1,0,1,1,100,0,2,1,1,0,2,2,0
"415","Caio Henrique Oliveira Silva",1085,20,14,14,5,1,9,22,NA,13,14,4,10,11,31,24,1
"416","Cala",137,2,1,1,1,0,1,2,NA,1,2,1,1,1,3,12,0
"417","Caleb Okoli",845,21,17,14,6,1,10,23,NA,13,9,5,4,26,47,41,3
"418","Callum Hudson-Odoi",938,4,3,3,0,1,3,5,NA,2,0,0,0,5,9,4,0
"419","Callum McGregor",216,3,1,2,1,0,2,5,NA,3,2,0,2,5,8,4,0
"420","Callum Wilson",835,4,1,0,4,0,0,1,NA,1,1,0,1,1,5,4,0
"421","Calum Chambers",101,2,2,2,0,0,1,2,NA,1,3,3,0,3,5,1,0
"422","Calvin Bassey",540,14,9,8,4,2,7,11,NA,4,9,4,5,7,21,23,0
"423","Calvin Ramsay",4,0,0,0,0,0,0,0,NA,0,0,0,0,0,0,1,0
"424","Calvin Stengs",212,2,2,1,0,1,1,2,NA,1,0,0,0,0,2,0,0
"425","Cameron Archer",49,0,0,0,0,0,0,0,NA,0,0,0,0,0,0,0,0
"426","Cameron Carter-Vickers",450,3,2,2,1,0,2,4,NA,2,3,1,2,4,7,19,0
"427","Carl Starfelt",90,0,0,0,0,0,0,0,NA,0,3,3,0,0,0,5,0
"428","Carles Aleñá",1022,11,8,4,2,5,3,21,NA,18,9,0,9,2,13,11,0
"429","Carles Pérez",599,13,8,4,6,3,6,12,NA,6,10,2,8,1,14,4,0
"430","Carlos",949,16,9,11,4,1,2,6,NA,4,6,2,4,6,22,23,1
"431","Carlos Baleba",66,6,5,1,4,1,5,5,NA,0,4,0,4,0,6,1,0
"432","Carlos Clerc",862,23,15,19,4,0,6,9,NA,3,10,3,7,7,30,27,1
"433","Carlos Dominguez",1,0,0,0,0,0,0,0,NA,0,0,0,0,0,0,0,0
"434","Carlos Fernández",232,2,2,0,2,0,0,5,NA,5,1,0,1,1,3,2,0
"435","Carlos Gruezo",1006,23,14,12,11,0,10,18,NA,8,13,4,9,10,33,15,0
"436","Carlos Martínez",45,1,1,0,1,0,1,2,50,1,1,0,1,1,2,1,0
"437","Carlos Soler",660,8,4,2,3,3,4,8,NA,4,5,2,3,3,11,4,0
"438","Carlos Vinícius",327,0,0,0,0,0,0,0,NA,0,1,0,1,0,0,3,0
"439","Carmona",892,19,15,10,3,6,12,22,NA,10,15,8,7,9,28,25,2
"440","Carney Chukwuemeka",46,0,0,0,0,0,0,0,NA,0,1,0,1,0,0,1,0
"441","Casals",12,NA,0,NA,NA,NA,NA,NA,NA,NA,NA,NA,NA,0,NA,NA,NA
"442","Casemiro",900,39,18,19,16,4,20,29,NA,9,22,6,16,18,57,25,0
"443","Casper Nielsen",529,16,12,5,9,2,6,11,NA,5,8,4,4,5,21,8,0
"444","Castello Lukeba",1260,10,6,8,1,1,7,9,NA,2,18,10,8,26,36,25,0
"445","Catena",1260,6,2,4,2,0,4,8,NA,4,11,9,2,7,13,61,1
"446","Cédric Avinel",697,6,3,3,3,0,2,3,NA,1,6,4,2,9,15,39,1
"447","Cédric Bakambu",59,2,1,2,0,0,2,2,NA,0,0,0,0,0,2,0,0
"448","Cédric Brunner",1017,12,11,7,3,2,10,16,NA,6,13,4,9,25,37,38,0
"449","Cédric Hountondji",1337,15,10,10,4,1,6,9,NA,3,17,8,9,20,35,48,0
"450","Cédric Soares",29,0,0,0,0,0,0,1,NA,1,1,0,1,0,0,1,0
"451","Celso Borges",159,3,0,1,2,0,1,1,NA,0,3,2,1,3,6,3,0
"452","Cengiz Ünder",727,14,9,6,6,2,4,7,NA,3,3,0,3,8,22,0,0
"453","Cenk Özkacar",239,4,3,2,2,0,1,1,NA,0,2,0,2,1,5,6,0
"454","César Azpilicueta",1022,23,15,14,5,4,15,17,NA,2,21,1,20,16,39,34,1
"455","César de la Hoz",583,12,7,5,6,1,5,11,NA,6,10,4,6,5,17,12,0
"456","César Montes",270,6,4,2,4,0,3,3,300,0,0,0,0,2,8,11,0
"457","Chadi Riad",2,0,0,0,0,0,0,0,NA,0,0,0,0,0,0,0,0
"458","Chancel Mbemba",1711,34,21,24,8,2,17,19,NA,2,17,7,10,23,57,51,0
"459","Charalambos Lykogiannis",543,9,4,3,3,3,4,8,NA,4,2,1,1,11,20,18,0
"460","Charles Aránguiz",708,21,9,8,11,2,13,22,NA,9,7,2,5,9,30,7,0
"461","Charles De Ketelaere",750,8,2,4,4,0,6,16,NA,10,13,2,11,5,13,1,0
"462","Charles Pickel",918,18,7,8,8,2,7,12,NA,5,10,2,8,7,25,9,0
"463","Charly Rodríguez",34,0,0,0,0,0,0,1,NA,1,2,0,2,0,0,0,0
"464","Che Adams",1066,10,9,4,5,1,4,5,NA,1,8,2,6,3,13,14,0
"465","Check Keita",121,2,2,2,0,0,0,0,NA,0,1,1,0,0,2,2,0
"466","Cheick Doucouré",963,25,19,13,10,2,11,20,NA,9,17,6,11,20,45,12,0
"467","Cheikhou Kouyaté",776,21,16,10,9,2,6,9,NA,3,15,2,13,7,28,24,0
"468","Chem Campbell",74,2,1,1,1,0,0,1,NA,1,2,0,2,1,3,0,0
"469","Chidera Ejuke",790,4,3,1,3,0,1,3,NA,2,3,0,3,2,6,0,0
"470","Chikwubuike Adamu",204,9,8,4,2,3,1,3,NA,2,5,1,4,1,10,0,0
"471","Chimuanya Ugochukwu",465,16,8,6,9,1,6,9,NA,3,8,2,6,6,22,6,0
"472","Chiquinho",83,5,4,2,2,1,0,0,NA,0,1,0,1,2,7,0,0
"473","Cho Guesung",107,0,0,0,0,0,0,2,NA,2,2,0,2,0,0,2,0
"474","Chris Führich",873,25,10,12,11,2,15,23,NA,8,18,2,16,4,29,4,0
"475","Chris Mepham",1521,25,15,17,8,0,10,15,NA,5,27,18,9,12,37,102,0
"476","Chris Richards",47,0,0,0,0,0,0,1,NA,1,3,1,2,2,2,5,0
"477","Chris Smalling",1143,7,4,5,2,0,1,5,NA,4,17,12,5,23,30,60,0
"478","Chris Wood",272,4,3,0,2,2,3,4,NA,1,2,2,0,0,4,4,0
"479","Chrislain Matsima",36,0,0,0,0,0,0,0,NA,0,0,0,0,1,1,5,0
"480","Christian Bassogog",24,0,0,0,0,0,0,0,NA,0,0,0,0,1,1,0,0
"481","Christian Eriksen",1313,9,7,5,2,2,3,10,NA,7,17,6,11,4,13,13,1
"482","Christian Groß",903,25,13,7,17,1,13,27,NA,14,12,3,9,12,37,16,0
"483","Christian Günter",1315,16,11,8,6,2,6,18,NA,12,11,4,7,7,23,17,0
"484","Christian Gytkjær",313,6,2,1,4,1,2,3,NA,1,1,0,1,0,6,0,0
"485","Christian Kouamé",923,9,6,3,2,4,2,5,NA,3,7,1,6,7,16,1,0
"486","Christian Nørgaard",344,9,3,4,5,0,3,8,NA,5,6,1,5,8,17,5,1
"487","Christian Pulisic",751,13,7,2,6,5,4,7,NA,3,5,0,5,4,17,5,0
"488","Christian Sørensen",102,1,1,0,0,1,1,2,NA,1,0,0,0,2,3,1,0
"489","Christoph Baumgartner",1150,14,8,5,8,1,4,19,NA,15,24,2,22,11,25,6,0
"490","Christoph Kramer",1183,24,17,13,9,2,16,31,NA,15,12,0,12,4,28,20,0
"491","Christophe Hérelle",337,3,2,2,1,0,1,3,NA,2,5,2,3,7,10,8,0
"492","Christopher Antwi-Adjei",453,6,4,2,1,3,2,7,NA,5,6,0,6,1,7,1,0
"493","Christopher Jullien",900,16,10,12,3,1,8,14,NA,6,14,5,9,12,28,41,0
"494","Christopher Lenz",629,18,11,8,8,2,9,17,NA,8,9,0,9,10,28,14,0
"495","Christopher Nkunku",1819,9,6,3,3,3,1,6,NA,5,7,2,5,10,19,11,0
"496","Christopher Trimmel",929,20,10,12,7,1,13,18,NA,5,11,1,10,16,36,23,0
"497","Christopher Wooh",454,3,0,3,0,0,0,1,NA,1,6,3,3,2,5,26,0
"498","Ciprian Tătărușanu",900,0,0,0,0,0,0,0,NA,0,0,0,0,0,0,4,0
"499","Ciro Immobile",811,4,3,1,2,1,2,2,NA,0,7,1,6,1,5,5,0
"500","Cisse Sandra",8,0,0,0,0,0,0,0,NA,0,0,0,0,0,0,0,0
"501","Ckene Doucouré",30,1,1,1,0,0,0,0,NA,0,0,0,0,1,2,0,0
"502","Claudio Bravo",180,0,0,0,0,0,0,0,NA,0,0,0,0,1,1,0,0
"503","Clément Grenier",404,11,4,3,7,1,5,7,NA,2,4,0,4,5,16,4,0
"504","Clément Lenglet",909,20,12,12,7,1,7,10,NA,3,10,4,6,8,28,25,0
"505","Clément Vidal",574,11,7,4,7,0,6,9,NA,3,7,6,1,10,21,16,0
"506","Clinton Mata",7,0,0,0,0,0,0,1,0,1,0,0,0,0,0,0,0
"507","Clinton Mola",15,3,1,2,1,0,1,1,100,0,1,1,0,1,4,2,0
"508","Cody Drameh",69,5,4,0,4,1,2,3,66.7,1,0,0,0,1,6,1,0
"509","Cody Gakpo",249,4,1,2,1,1,2,2,NA,0,4,0,4,2,6,4,0
"510","Cole Palmer",244,4,1,0,2,2,2,2,NA,0,3,0,3,1,5,1,0
"511","Colin Dagba",463,14,8,7,5,2,7,9,NA,2,9,2,7,10,24,10,0
"512","Collins Fai",180,2,0,1,1,0,2,2,NA,0,2,0,2,1,3,3,0
"513","Connor Goldson",314,6,3,1,5,0,3,7,183.3,4,8,3,5,5,11,19,0
"514","Connor Roberts",200,3,3,2,1,0,3,4,NA,1,2,2,0,1,4,8,0
"515","Connor Ronan",1,0,0,0,0,0,0,0,NA,0,0,0,0,0,0,0,0
"516","Conor Coady",1250,8,5,5,3,0,3,3,NA,0,10,10,0,8,16,62,2
"517","Conor Coventry",1,0,0,0,0,0,0,0,NA,0,0,0,0,0,0,0,0
"518","Conor Gallagher",693,24,19,7,10,7,7,12,NA,5,6,1,5,12,36,12,0
"519","Copete",997,26,16,16,9,1,11,13,NA,2,18,6,12,25,51,45,0
"520","Corentin Tolisso",538,8,6,3,3,2,4,16,NA,12,3,0,3,7,15,4,0
"521","Craig Dawson",450,7,5,7,0,0,3,3,NA,0,5,3,2,3,10,15,0
"522","Craig Goodwin",201,4,3,1,2,1,2,5,NA,3,2,0,2,0,4,3,0
"523","Cristhian Mosquera",55,1,1,1,0,0,1,1,NA,0,0,0,0,1,2,3,0
"524","Cristhian Stuani",419,4,1,1,1,2,3,5,NA,2,1,0,1,1,5,4,0
"525","Cristian Buonaiuto",304,11,5,3,5,3,5,8,NA,3,5,0,5,5,16,3,0
"526","Cristian Gamboa",1272,37,20,26,10,1,17,25,NA,8,17,6,11,14,51,31,1
"527","Cristian Romero",1260,33,20,12,21,0,14,28,NA,14,15,6,9,20,53,41,1
"528","Cristian Volpato",117,1,0,0,0,1,0,0,NA,0,2,0,2,1,2,0,0
"529","Cristiano Biraghi",1052,30,17,12,17,1,18,23,NA,5,8,3,5,3,33,19,0
"530","Cristiano Ronaldo",693,2,2,1,0,1,1,2,NA,1,0,0,0,1,3,10,0
"531","Crysencio Summerville",473,12,8,7,4,1,5,8,NA,3,9,1,8,3,15,4,0
"532","Curro",43,2,0,1,1,0,1,2,NA,1,0,0,0,0,2,0,0
"533","Curtis Jones",272,6,2,1,3,2,3,5,NA,2,4,0,4,2,8,1,0
"534","Cyle Larin",90,0,0,0,0,0,0,0,NA,0,0,0,0,0,0,0,0
"535","Cyriel Dessers",860,7,1,3,3,1,2,2,NA,0,7,1,6,3,10,3,0
"536","Cyrille Bayala",763,25,17,9,7,9,12,19,NA,7,9,2,7,11,36,5,0
"537","Daichi Kamada",1657,41,24,10,28,3,25,35,NA,10,17,3,14,14,55,11,1
"538","Daizen Maeda",386,8,4,0,6,2,1,5,NA,4,10,2,8,7,15,1,0
"539","Daley Blind",677,21,13,8,7,6,12,16,NA,4,10,2,8,6,27,11,1
"540","Daley Sinkgraven",177,2,2,1,1,0,2,2,NA,0,3,3,0,3,5,3,0
"541","Damián Suárez",549,10,7,3,4,3,4,8,NA,4,9,0,9,5,15,14,0
"542","Damian Szymański",29,0,0,0,0,0,0,1,0,1,0,0,0,1,1,0,0
"543","Damien Da Silva",158,2,2,1,1,0,0,0,NA,0,0,0,0,4,6,4,0
"544","Dan-Axel Zagadou",441,4,2,3,1,0,1,4,NA,3,8,7,1,4,8,31,1
"545","Dan Burn",1224,18,12,9,4,5,9,20,NA,11,12,7,5,15,33,55,0
"546","Dango Ouattara",1193,28,20,16,6,6,10,19,NA,9,19,6,13,16,44,17,0
"547","Dani Carvajal",1316,25,12,10,11,4,15,24,NA,9,18,4,14,14,39,31,0
"548","Dani Ceballos",209,9,4,2,3,4,4,10,NA,6,5,0,5,5,14,1,0
"549","Dani García",363,7,4,3,3,1,5,8,NA,3,2,0,2,3,10,4,0
"550","Dani Gómez",66,2,1,1,1,0,1,1,NA,0,0,0,0,1,3,0,0
"551","Dani Olmo",757,13,8,4,5,4,6,9,NA,3,13,0,13,3,16,1,0
"552","Dani Rodríguez",689,15,6,8,6,1,6,13,NA,7,8,2,6,10,25,7,0
"553","Daniel Amartey",1095,17,7,11,5,1,9,10,NA,1,15,9,6,8,25,41,0
"554","Daniel Caligiuri",258,7,5,4,3,0,4,5,NA,1,2,2,0,3,10,2,0
"555","Daniel Chacón",1,0,0,0,0,0,0,0,NA,0,0,0,0,0,0,1,0
"556","Daniel Ciofani",229,3,1,1,0,2,2,3,NA,1,3,0,3,0,3,2,0
"557","Daniel James",659,9,5,2,4,3,5,12,NA,7,7,1,6,3,12,7,0
"558","Daniel Kyereh",443,6,5,2,4,0,3,6,NA,3,3,0,3,0,6,8,0
"559","Daniel Maldini",98,2,0,0,0,2,1,3,NA,2,3,0,3,0,2,3,0
"560","Daniel Parejo",1227,24,13,10,8,6,8,26,NA,18,15,6,9,10,34,13,1
"561","Daniel Podence",1020,14,10,8,4,2,2,12,NA,10,12,0,12,3,17,4,0
"562","Daniel Sundgren",324,12,8,9,3,0,8,11,310,3,7,4,3,5,17,11,0
"563","Daniel Vivian",635,11,6,9,2,0,6,7,NA,1,4,3,1,11,22,26,1
"564","Daniele Montevago",159,1,0,0,0,1,0,0,NA,0,1,1,0,0,1,1,0
"565","Daniele Rugani",258,2,2,0,2,0,1,1,NA,0,4,2,2,4,6,11,0
"566","Daniele Verde",258,0,0,0,0,0,0,0,NA,0,2,0,2,2,2,2,0
"567","Danilho Doekhi",534,13,9,9,4,0,6,9,NA,3,10,3,7,10,23,16,0
"568","Danilo",1610,33,15,25,7,1,17,25,NA,8,14,6,8,24,57,44,0
"569","Danilo Cataldi",709,15,8,5,9,1,9,25,300,16,5,3,2,6,21,15,0
"570","Danilo D'Ambrosio",224,6,3,3,3,0,5,8,NA,3,5,3,2,4,10,9,0
"571","Danilo Pereira",1065,13,9,7,4,2,10,12,NA,2,9,7,2,13,26,22,1
"572","Danilo Soares",824,33,19,20,10,3,19,27,718.3,8,18,2,16,11,44,17,0
"573","Danny da Costa",427,3,3,0,3,0,1,2,NA,1,12,2,10,5,8,6,0
"574","Danny Ings",726,8,4,0,5,3,1,4,NA,3,7,0,7,1,9,7,0
"575","Danny Latza",184,5,5,3,2,0,2,4,NA,2,4,0,4,0,5,4,0
"576","Danny Loader",46,2,2,1,1,0,1,1,NA,0,0,0,0,0,2,0,0
"577","Danny Ward",1444,0,0,0,0,0,0,0,NA,0,0,0,0,0,0,10,3
"578","Danny Welbeck",996,8,5,0,4,4,3,5,NA,2,10,1,9,3,11,11,0
"579","Dante",1260,26,16,18,7,1,11,16,NA,5,21,12,9,24,50,45,1
"580","Dany Jean",9,0,0,0,0,0,0,0,NA,0,1,0,1,0,0,0,0
"581","Dany Mota",514,5,4,0,2,3,1,1,NA,0,2,0,2,1,6,5,0
"582","Danylo Sikan",104,0,0,0,0,0,0,1,NA,1,0,0,0,0,0,2,0
"583","Dario Essugo",28,2,2,0,2,0,0,0,NA,0,1,1,0,0,2,0,0
"584","Dario Špikić",167,2,1,0,1,1,0,1,NA,1,4,2,2,4,6,0,0
"585","Darko Brašanac",485,11,7,4,5,2,1,3,NA,2,7,1,6,7,18,3,0
"586","Darko Churlinov",27,3,2,2,1,0,2,3,66.7,1,1,0,1,0,3,0,0
"587","Darko Lazović",775,13,7,5,7,1,4,13,NA,9,5,2,3,6,19,9,0
"588","Darlin Yongwa",40,2,2,1,1,0,1,2,NA,1,1,0,1,0,2,1,0
"589","Darwin Núñez",1045,8,5,4,3,1,3,5,NA,2,7,0,7,3,11,5,0
"590","David Alaba",1535,12,6,3,6,3,9,13,NA,4,14,10,4,12,24,27,1
"591","David Carmo",450,5,2,4,1,0,1,5,NA,4,2,1,1,4,9,16,0
"592","David de Gea",1260,0,0,0,0,0,0,0,NA,0,0,0,0,0,0,7,1
"593","David García",1039,15,8,11,4,0,9,10,NA,1,6,3,3,19,34,56,0
"594","David López",690,9,6,4,5,0,5,6,NA,1,11,7,4,4,13,32,1
"595","David Neres",318,10,6,3,5,2,2,4,NA,2,10,2,8,1,11,1,0
"596","David Okereke",1075,6,5,3,1,2,0,5,NA,5,14,3,11,4,10,7,0
"597","David Pereira da Costa",983,8,4,1,5,2,4,15,NA,11,9,0,9,7,15,4,0
"598","David Raum",1649,37,21,23,10,4,18,34,NA,16,28,6,22,22,59,30,1
"599","David Raya",1350,0,0,0,0,0,0,1,NA,1,0,0,0,0,0,4,1
"600","David Silva",816,12,6,4,7,1,2,5,NA,3,3,0,3,5,17,7,0
"601","David Soria",1260,0,0,0,0,0,0,0,NA,0,0,0,0,0,0,6,3
"602","Dávid Strelec",168,2,2,0,1,1,2,2,NA,0,0,0,0,0,2,0,0
"603","David Turnbull",103,1,0,1,0,0,0,2,NA,2,2,1,1,0,1,0,0
"604","David Zima",309,8,4,4,4,0,3,3,NA,0,7,2,5,8,16,10,1
"605","Davide Calabria",664,28,17,15,8,5,15,24,535,9,10,3,7,13,41,7,0
"606","Davide Faraoni",371,6,4,2,4,0,2,9,NA,7,7,2,5,5,11,5,0
"607","Davide Frattesi",1120,21,12,9,9,3,10,19,NA,9,7,1,6,2,23,14,0
"608","Davide Zappacosta",90,4,2,2,1,1,1,2,100,1,1,0,1,0,4,1,0
"609","Davie Selke",282,2,1,1,1,0,0,1,NA,1,3,1,2,1,3,5,0
"610","Davinson Sánchez",544,14,5,10,3,1,9,9,NA,0,7,6,1,10,24,25,0
"611","Davit Khocholava",428,2,1,2,0,0,2,3,NA,1,4,3,1,10,12,21,0
"612","Davy Klaassen",357,2,2,1,1,0,1,5,NA,4,3,0,3,1,3,3,0
"613","Dayot Upamecano",1873,53,32,36,17,0,21,31,NA,10,19,6,13,28,81,61,4
"614","Dean David",237,3,2,2,0,1,1,2,NA,1,0,0,0,0,3,0,0
"615","Dean Henderson",1350,0,0,0,0,0,0,0,NA,0,0,0,0,0,0,9,1
"616","DeAndre Yedlin",17,1,0,0,1,0,1,1,100,0,0,0,0,0,1,1,0
"617","Declan Rice",1587,38,18,17,19,2,12,16,NA,4,23,11,12,31,69,24,0
"618","Dedryck Boyata",136,1,0,1,0,0,1,1,NA,0,1,1,0,7,8,7,0
"619","Degnand Gnonto",109,4,2,1,2,1,0,3,NA,3,1,0,1,0,4,4,0
"620","Deiver Machado",1003,28,18,8,14,6,12,17,NA,5,10,4,6,12,40,11,0
"621","Dejan Kulusevski",660,8,1,4,2,2,2,11,NA,9,6,0,6,1,9,0,0
"622","Dejan Ljubicic",560,11,7,1,7,3,5,14,NA,9,5,0,5,5,16,1,0
"623","Dejan Lovren",180,5,2,3,1,1,2,3,150,1,3,3,0,3,8,8,0
"624","Delano Burgzorg",211,3,3,1,1,1,2,3,NA,1,2,0,2,0,3,1,0
"625","Dele Alli",40,0,0,0,0,0,0,0,NA,0,0,0,0,0,0,0,0
"626","Demarai Gray",1284,13,10,2,7,4,8,12,NA,4,9,1,8,6,19,13,0
"627","Demba Seck",213,4,2,2,2,0,2,2,NA,0,3,1,2,1,5,0,0
"628","Denis Genreau",95,10,4,2,6,2,2,6,NA,4,4,0,4,2,12,4,0
"629","Denis Huseinbasic",376,14,6,7,3,4,7,14,NA,7,9,1,8,2,16,3,0
"630","Denis Odoi",443,11,2,7,3,1,7,8,500,1,9,5,4,7,18,17,0
"631","Denis Vavro",360,3,1,3,0,0,2,3,NA,1,7,6,1,7,10,22,0
"632","Denis Zakaria",193,6,3,1,4,1,2,2,NA,0,2,0,2,4,10,1,0
"633","Deniz Undav",101,2,2,1,1,0,0,0,NA,0,0,0,0,0,2,0,0
"634","Dennis Appiah",794,21,11,14,7,0,10,27,NA,17,13,5,8,10,31,16,0
"635","Dennis Geiger",1001,22,11,7,14,1,10,19,NA,9,15,2,13,11,33,5,0
"636","Dennis Praet",266,9,7,5,3,1,5,8,NA,3,4,0,4,1,10,3,0
"637","Denso Kasius",336,12,6,7,4,1,8,10,NA,2,6,3,3,3,15,6,0
"638","Dénys Bain",126,4,3,3,1,0,1,2,NA,1,2,1,1,2,6,4,0
"639","Denzel Dumfries",1623,19,11,10,7,2,12,19,NA,7,18,4,14,14,33,25,0
"640","Derry Scherhant",40,0,0,0,0,0,0,0,NA,0,0,0,0,0,0,0,0
"641","Désiré Doué",403,16,6,4,11,1,8,12,NA,4,6,1,5,6,22,0,0
"642","Devis Epassy",90,0,0,0,0,0,0,0,NA,0,0,0,0,0,0,1,0
"643","Devyne Rensch",287,14,9,8,6,0,11,14,NA,3,4,0,4,4,18,10,0
"644","Dexter Lembikisa",23,0,0,0,0,0,0,0,NA,0,0,0,0,0,0,0,0
"645","Diadie Samassékou",34,1,0,0,1,0,0,1,NA,1,0,0,0,0,1,0,0
"646","Diego Carlos",179,1,0,0,1,0,0,1,NA,1,2,2,0,1,2,2,0
"647","Diego Coppola",495,12,7,5,7,0,4,8,NA,4,9,3,6,7,19,18,0
"648","Diego Costa",412,0,0,0,0,0,0,0,NA,0,2,1,1,0,0,3,0
"649","Diego Demme",21,0,0,0,0,0,0,1,NA,1,1,0,1,0,0,0,0
"650","Diego Godín",151,0,0,0,0,0,0,0,NA,0,0,0,0,1,1,9,0
"651","Diego González",327,4,4,2,2,0,2,4,NA,2,3,3,0,3,7,19,0
"652","Diego Llorente",630,13,10,8,5,0,4,7,NA,3,5,1,4,15,28,22,2
"653","Diego López",90,0,0,0,0,0,0,0,NA,0,0,0,0,0,0,0,1
"654","Diego Noguerol",10,0,0,0,0,0,0,0,NA,0,0,0,0,0,0,0,0
"655","Diego Rico",594,14,11,4,6,4,4,7,NA,3,2,0,2,5,19,16,0
"656","Diego Valencia",144,4,2,2,1,1,2,5,NA,3,5,0,5,1,5,2,0
"657","Dijon Kameri",121,NA,1,NA,NA,NA,NA,NA,NA,NA,NA,NA,NA,0,NA,NA,NA
"658","Dimitri Foulquier",287,4,4,2,2,0,1,1,NA,0,2,0,2,2,6,4,0
"659","Dimitri Liénard",744,19,11,10,7,2,15,22,NA,7,12,4,8,8,27,12,0
"660","Dimitri Payet",544,4,3,1,1,2,2,6,NA,4,3,0,3,1,5,2,0
"661","Dimitris Nikolaou",1149,15,10,10,5,0,7,8,NA,1,17,13,4,12,27,25,0
"662","Dino Perić",540,8,4,7,1,0,5,5,NA,0,10,7,3,14,22,54,1
"663","Diogo Costa",720,1,0,1,0,0,0,0,NA,0,0,0,0,0,1,4,0
"664","Diogo Dalot",1165,27,23,23,4,0,15,23,NA,8,16,6,10,20,47,28,1
"665","Diogo Gonçalves",40,1,0,1,0,0,1,1,NA,0,0,0,0,0,1,0,0
"666","Diogo Jota",376,13,9,9,4,0,6,7,NA,1,3,0,3,2,15,2,0
"667","Diogo Leite",1098,21,13,13,8,0,13,15,NA,2,11,7,4,14,35,40,0
"668","Dion Lopy",604,16,8,9,6,1,8,24,NA,16,17,2,15,13,29,12,0
"669","Divock Origi",349,2,0,1,1,0,1,1,NA,0,2,1,1,0,2,8,0
"670","Djed Spence",4,0,0,0,0,0,0,0,NA,0,0,0,0,0,0,0,0
"671","Djené",1002,9,5,8,1,0,5,8,NA,3,4,4,0,12,21,25,1
"672","Djibril Sow",1854,28,17,9,17,2,12,23,NA,11,14,2,12,32,60,16,0
"673","Djorkaeff Reasco",27,0,0,0,0,0,0,0,NA,0,0,0,0,0,0,0,0
"674","Dmytro Kryskiv",10,0,0,0,0,0,0,1,0,1,0,0,0,0,0,0,0
"675","Dodi Lukebakio",1258,12,7,3,7,2,6,14,NA,8,13,5,8,7,19,10,0
"676","Dodô",778,16,8,7,7,2,8,12,NA,4,5,0,5,8,24,7,0
"677","Doğan Alemdar",225,0,0,0,0,0,0,0,NA,0,0,0,0,0,0,1,1
"678","Dolev Haziz",211,7,5,4,2,1,4,7,125,3,0,0,0,2,9,3,0
"679","Domagoj Bradarić",330,1,0,0,1,0,1,3,NA,2,3,0,3,3,4,4,0
"680","Domenico Berardi",384,4,4,2,0,2,2,10,NA,8,1,0,1,3,7,2,0
"681","Domingos André Ribeiro Almeida",706,14,7,4,7,3,4,7,NA,3,5,0,5,5,19,4,0
"682","Domingos Duarte",1125,12,7,10,2,0,10,12,NA,2,15,13,2,18,30,65,0
"683","Domingos Quina",268,3,2,2,1,0,1,3,NA,2,5,0,5,3,6,1,0
"684","Dominic Calvert-Lewin",339,1,1,0,0,1,0,0,NA,0,1,0,1,0,1,3,0
"685","Dominic Solanke",1071,6,4,3,1,2,2,7,NA,5,10,4,6,1,7,17,0
"686","Dominick Drexler",726,12,9,7,3,2,2,8,NA,6,9,1,8,2,14,7,0
"687","Dominik Kohr",1175,28,18,6,19,3,12,33,NA,21,20,4,16,17,45,13,0
"688","Dominik Livaković",720,0,0,0,0,0,0,0,NA,0,0,0,0,0,0,4,0
"689","Dominik Szoboszlai",1438,21,15,4,8,9,8,20,NA,12,18,1,17,11,32,10,0
"690","Dominique Heintz",341,5,3,3,2,0,2,5,NA,3,7,5,2,4,9,16,0
"691","Donny van de Beek",87,0,0,0,0,0,0,1,NA,1,0,0,0,0,0,0,0
"692","Donyell Malen",905,5,2,3,1,1,1,3,NA,2,10,0,10,4,9,4,0
"693","Douglas Luiz",930,25,15,12,9,4,9,16,NA,7,15,2,13,16,41,5,1
"694","Dries Mertens",31,2,0,1,1,0,2,3,66.7,1,0,0,0,0,2,0,0
"695","Duccio Degli Innocenti",3,0,0,0,0,0,0,0,NA,0,0,0,0,1,1,0,0
"696","Duje Ćaleta-Car",494,6,4,4,2,0,2,2,NA,0,7,7,0,9,15,19,0
"697","Dušan Tadić",612,10,5,1,7,2,6,11,350,5,10,2,8,1,11,5,0
"698","Dušan Vlahović",1285,7,4,0,3,4,3,5,NA,2,8,3,5,1,8,6,1
"699","Duván Zapata",489,1,1,0,0,1,1,2,NA,1,1,0,1,0,1,9,0
"700","Dwight McNeil",734,27,18,16,5,6,9,14,NA,5,12,0,12,7,34,11,0
"701","Dyego Sousa",306,4,2,2,1,1,2,2,NA,0,3,1,2,0,4,8,0
"702","Dylan Batubinsika",450,8,1,7,1,0,3,5,NA,2,3,1,2,10,18,14,0
"703","Dylan Bronn",969,20,9,8,11,1,9,14,NA,5,16,12,4,13,33,28,0
"704","Eberechi Eze",1139,15,10,6,6,3,5,10,NA,5,9,0,9,3,18,2,0
"705","Eddie Nketiah",152,3,2,1,1,1,0,1,NA,1,2,0,2,1,4,1,0
"706","Eden Hazard",351,0,0,0,0,0,0,2,NA,2,2,0,2,2,2,0,0
"707","Éder Álvarez Balanta",50,0,0,0,0,0,0,0,NA,0,1,1,0,2,2,1,0
"708","Éder Militão",1300,23,12,15,7,1,15,17,NA,2,27,15,12,17,40,49,1
"709","Ederson",1620,1,0,1,0,0,1,1,NA,0,0,0,0,0,1,8,1
"710","Éderson",650,19,12,4,14,1,4,7,NA,3,15,1,14,10,29,6,0
"711","Édgar Badía",1260,1,0,1,0,0,1,1,NA,0,0,0,0,0,1,8,2
"712","Édgar González",845,13,11,10,3,0,9,13,NA,4,7,7,0,10,23,54,0
"713","Edimilson Fernandes",851,15,13,11,2,2,9,14,NA,5,13,3,10,29,44,22,0
"714","Edin Džeko",1216,2,1,1,1,0,1,6,NA,5,9,0,9,1,3,26,0
"715","Edinson Cavani",529,2,0,1,0,1,0,5,NA,5,5,2,3,0,2,2,0
"716","Edmond Tapsoba",1661,34,20,24,8,2,19,28,NA,9,19,10,9,23,57,55,1
"717","Edoardo Bove",47,2,0,0,1,1,0,0,NA,0,2,0,2,1,3,2,0
"718","Edon Zhegrova",234,9,6,4,2,3,9,12,NA,3,0,0,0,1,10,1,0
"719","Edouard Mendy",1125,0,0,0,0,0,0,0,NA,0,0,0,0,0,0,5,3
"720","Edson Álvarez",706,18,10,8,9,1,9,15,466.7,6,6,1,5,15,33,20,0
"721","Edu Expósito",772,24,15,9,13,2,9,14,NA,5,5,0,5,9,33,13,0
"722","Eduard Sobol",109,3,1,3,0,0,2,3,NA,1,1,0,1,2,5,3,0
"723","Eduardo Camavinga",813,34,24,15,14,5,6,14,NA,8,15,2,13,6,40,9,0
"724","Eduardo Simões",88,5,3,3,2,0,1,3,NA,2,3,2,1,0,5,3,0
"725","Ehsan Hajsafi",237,6,3,2,3,1,3,5,233.3,2,3,0,3,2,8,2,0
"726","El Bilal Touré",659,1,1,1,0,0,0,2,NA,2,4,1,3,0,1,14,0
"727","El Chadaille Bitshiabu",8,0,0,0,0,0,0,0,NA,0,0,0,0,0,0,2,0
"728","Elba Rashani",766,13,6,4,6,3,3,6,NA,3,8,2,6,10,23,8,0
"729","Eldor Shomurodov",111,1,0,1,0,0,0,1,NA,1,1,0,1,1,2,0,0
"730","Elias Jelert",192,4,2,2,2,0,1,4,NA,3,0,0,0,1,5,1,0
"731","Elif Elmas",559,14,4,3,8,3,8,10,NA,2,5,0,5,4,18,3,0
"732","Eliot Matazo",355,3,0,1,2,0,1,4,NA,3,4,1,3,2,5,3,0
"733","Elliot Anderson",103,5,3,4,0,1,2,4,NA,2,4,1,3,2,7,0,0
"734","Ellyes Skhiri",1530,50,24,18,28,4,16,34,NA,18,21,6,15,28,78,20,0
"735","Elseid Hysaj",269,8,4,4,3,1,2,3,NA,1,5,3,2,2,10,5,0
"736","Elvis Rexhbeçaj",1219,26,17,7,12,7,12,29,NA,17,17,6,11,7,33,19,0
"737","Emanuel Aiwum",877,38,23,22,14,2,19,26,941.7,7,14,9,5,19,57,32,1
"738","Emanuel Vignato",197,3,3,1,2,0,2,4,NA,2,2,0,2,2,5,0,0
"739","Emanuele Valeri",979,19,10,11,7,1,10,21,NA,11,4,2,2,11,30,16,0
"740","Emerson",1283,35,19,22,8,5,14,24,NA,10,13,3,10,11,46,38,0
"741","Emerson Palmieri",224,3,1,0,3,0,1,1,NA,0,2,0,2,2,5,2,0
"742","Emi Buendía",726,23,9,9,8,6,7,17,NA,10,7,0,7,5,28,5,0
"743","Emil Audero",1260,0,0,0,0,0,0,1,NA,1,0,0,0,0,0,5,0
"744","Emil Bohinen",126,2,1,1,0,1,2,2,NA,0,1,0,1,1,3,0,0
"745","Emil Ceide",243,3,1,3,0,0,3,4,NA,1,1,0,1,1,4,0,0
"746","Emil Forsberg",860,14,9,3,5,6,6,15,NA,9,12,0,12,1,15,4,0
"747","Emil Holm",942,17,12,8,5,4,12,21,NA,9,11,3,8,6,23,27,0
"748","Emil Krafth",1,0,0,0,0,0,0,0,NA,0,0,0,0,0,0,0,0
"749","Emile Smith Rowe",51,1,1,1,0,0,1,2,NA,1,0,0,0,0,1,2,0
"750","Emiliano Marcondes",9,0,0,0,0,0,0,0,NA,0,0,0,0,0,0,1,0
"751","Emiliano Martínez",1564,0,0,0,0,0,0,0,NA,0,0,0,0,1,1,4,1
"752","Emirhan İlkhan",87,1,1,0,1,0,1,1,NA,0,3,1,2,2,3,2,0
"753","Emmanuel Agbadou",969,29,18,20,9,0,16,22,NA,6,13,6,7,13,42,54,1
"754","Emmanuel Dennis",345,4,2,1,2,1,1,1,NA,0,5,0,5,0,4,2,0
"755","Emmanuel Ekong",14,0,0,0,0,0,0,0,NA,0,0,0,0,0,0,0,0
"756","Emmanuel Gyasi",1034,9,4,3,6,0,3,10,NA,7,12,3,9,3,12,8,0
"757","Emre Can",784,27,18,10,14,3,8,15,NA,7,17,2,15,13,40,14,1
"758","Enes Ünal",1212,12,6,4,7,1,4,10,NA,6,6,1,5,0,12,19,0
"759","Enner Valencia",255,2,0,0,2,0,0,1,NA,1,3,0,3,1,3,2,0
"760","Enock Mwepu",213,10,5,1,6,3,3,4,NA,1,3,1,2,1,11,1,0
"761","Enrique Valiente",458,5,3,4,1,0,4,4,NA,0,7,3,4,2,7,22,0
"762","Enzo Barrenechea",3,0,0,0,0,0,0,0,NA,0,0,0,0,0,0,0,0
"763","Enzo Ebosse",677,6,2,4,2,0,3,6,NA,3,17,3,14,8,14,19,0
"764","Enzo Fernández",571,23,9,10,9,4,10,16,NA,6,5,1,4,11,34,4,0
"765","Enzo Le Fée",1331,48,28,21,19,8,18,51,414,33,22,2,20,14,62,18,1
"766","Enzo Millot",354,10,7,5,3,2,4,7,NA,3,13,2,11,9,19,4,0
"767","Enzo Roco",795,11,6,9,2,0,6,10,NA,4,7,5,2,6,17,22,1
"768","Enzo Tchato",692,14,9,5,8,1,6,12,NA,6,8,0,8,4,18,24,0
"769","Eray Cömert",872,12,7,9,3,0,8,13,NA,5,13,6,7,12,24,29,1
"770","Eren Dinkçi",52,2,2,2,0,0,1,1,NA,0,1,0,1,0,2,0,0
"771","Erhan Mašović",724,16,12,7,9,0,9,15,NA,6,14,9,5,5,21,23,0
"772","Eric Bailly",513,12,10,4,7,1,7,8,NA,1,8,7,1,20,32,14,0
"773","Eric Dier",1833,19,12,11,7,1,8,14,NA,6,15,10,5,27,46,67,3
"774","Eric García",833,16,9,11,3,2,6,9,NA,3,13,6,7,13,29,14,1
"775","Eric Martel",767,19,10,8,7,4,13,25,NA,12,5,1,4,12,31,14,0
"776","Eric Maxim Choupo-Moting",908,12,7,3,8,1,2,3,NA,1,9,0,9,1,13,5,0
"777","Erick Gutiérrez",49,1,1,0,1,0,1,3,33.3,2,0,0,0,2,3,1,0
"778","Erik Botheim",315,4,3,0,2,2,2,2,NA,0,1,0,1,0,4,1,0
"779","Erik Jirka",266,2,0,2,0,0,1,3,NA,2,2,1,1,7,9,5,0
"780","Érik Lamela",1234,23,13,8,7,8,7,18,NA,11,17,1,16,4,27,0,0
"781","Erik Palmer-Brown",1247,21,13,16,5,0,9,13,NA,4,22,10,12,12,33,63,0
"782","Erling Haaland",1285,2,1,0,2,0,1,2,NA,1,4,0,4,2,4,4,0
"783","Ermedin Demirović",1142,14,5,5,4,5,5,8,NA,3,17,2,15,10,24,18,0
"784","Esteban Saveljich",1,0,0,0,0,0,0,0,NA,0,0,0,0,0,0,0,0
"785","Ethan Ampadu",998,21,15,11,8,2,5,13,NA,8,19,10,9,11,32,26,0
"786","Ethan Nwaneri",1,0,0,0,0,0,0,0,NA,0,1,0,1,0,0,0,0
"787","Ethan Pinnock",630,4,3,2,2,0,1,2,NA,1,7,6,1,7,11,56,1
"788","Étienne Capoue",836,15,8,5,9,1,8,9,NA,1,7,2,5,10,25,14,0
"789","Evanilson",403,2,1,0,1,1,1,4,NA,3,3,1,2,1,3,4,0
"790","Evann Guessand",624,10,8,4,4,2,3,7,NA,4,4,1,3,0,10,1,0
"791","Exequiel Palacios",675,28,12,8,18,2,16,22,NA,6,11,1,10,14,42,12,1
"792","Ezequiel Ávila",838,4,3,2,2,0,3,10,NA,7,4,0,4,4,8,6,0
"793","Ezequiel Ponce",512,5,4,0,3,2,0,2,NA,2,3,1,2,0,5,9,0
"794","Ezri Konsa",1261,19,6,13,4,2,8,9,NA,1,13,7,6,12,31,49,1
"795","Fabian Frei",25,1,1,1,0,0,0,1,NA,1,0,0,0,1,2,0,0
"796","Fabian Rieder",68,3,2,1,1,1,1,2,NA,1,2,0,2,0,3,1,0
"797","Fabián Ruiz Peña",579,21,6,9,10,2,16,36,NA,20,12,1,11,4,25,3,1
"798","Fabian Schär",1243,16,6,10,5,1,8,11,NA,3,23,14,9,20,36,62,0
"799","Fabiano Parisi",1040,31,17,18,10,3,16,25,NA,9,14,4,10,18,49,37,0
"800","Fabien Centonze",173,6,3,4,2,0,5,5,NA,0,0,0,0,7,13,2,0
"801","Fabinho",1449,34,15,12,17,5,10,29,NA,19,18,5,13,22,56,19,0
"802","Fábio",192,4,2,1,2,1,4,5,NA,1,1,0,1,2,6,9,0
"803","Fábio Cardoso",270,5,1,3,1,1,3,4,250,1,2,1,1,3,8,11,0
"804","Fabio Carvalho",451,10,9,3,5,2,3,10,NA,7,9,1,8,5,15,0,0
"805","Fabio Chiarodia",3,0,0,0,0,0,0,0,NA,0,0,0,0,1,1,1,0
"806","Fabio Depaoli",624,15,8,9,5,1,8,12,NA,4,9,2,7,3,18,11,0
"807","Fabio Miretti",729,15,7,10,4,1,7,15,NA,8,9,1,8,2,17,4,0
"808","Fabio Quagliarella",303,1,1,0,1,0,0,3,NA,3,4,0,4,0,1,3,0
"809","Fabio Vieira",246,4,2,3,0,1,2,3,NA,1,1,0,1,3,7,0,0
"810","Fabrizio Angileri",510,7,5,4,2,1,5,11,NA,6,7,3,4,6,13,8,0
"811","Facundo Medina",1225,9,5,4,5,0,5,13,NA,8,10,4,6,14,23,24,1
"812","Facundo Pellistri",116,1,1,0,0,1,0,0,NA,0,0,0,0,0,1,1,0
"813","Faitout Maouassa",655,19,13,12,7,0,6,11,NA,5,14,1,13,11,30,7,0
"814","Falaye Sacko",881,18,7,7,8,3,10,14,NA,4,18,6,12,14,32,22,1
"815","Fali",556,10,6,6,4,0,6,9,NA,3,5,3,2,3,13,25,0
"816","Famara Diedhiou",73,0,0,0,0,0,0,0,NA,0,0,0,0,0,0,2,0
"817","Fares Chaïbi",832,12,5,3,6,3,5,14,NA,9,15,3,12,9,21,7,1
"818","Farid El Melali",190,7,4,2,5,0,4,5,NA,1,3,0,3,3,10,0,0
"819","Faride Alidou",156,9,6,5,4,0,3,7,NA,4,2,0,2,2,11,0,0
"820","Fashion Sakala",235,4,3,1,3,0,3,4,NA,1,1,0,1,2,6,1,0
"821","Fede San Emeterio",789,9,4,5,2,2,3,12,NA,9,17,7,10,3,12,7,0
"822","Federico Baschirotto",1260,17,13,15,2,0,5,5,NA,0,19,12,7,15,32,75,0
"823","Federico Bonazzoli",644,1,1,0,0,1,0,5,NA,5,1,0,1,3,4,0,0
"824","Federico Ceccherini",499,10,7,6,3,1,4,7,NA,3,6,1,5,7,17,16,0
"825","Federico Chiesa",44,1,0,1,0,0,1,1,NA,0,2,0,2,0,1,0,0
"826","Federico Di Francesco",634,7,5,1,3,3,2,10,NA,8,8,0,8,2,9,8,0
"827","Federico Dimarco",1208,14,10,4,8,2,5,8,NA,3,11,3,8,15,29,23,0
"828","Federico Fazio",629,9,7,5,4,0,3,6,NA,3,7,3,4,19,28,28,0
"829","Federico Fernández",90,1,1,1,0,0,1,1,100,0,0,0,0,2,3,12,0
"830","Federico Gatti",540,5,4,5,0,0,3,5,NA,2,8,5,3,8,13,27,1
"831","Federico Valverde",1715,25,13,8,11,6,11,23,NA,12,21,1,20,14,39,7,0
"832","Felipe",270,7,6,4,3,0,3,5,166.7,2,6,5,1,1,8,12,1
"833","Felipe Anderson",947,24,16,7,14,3,11,23,NA,12,25,1,24,8,32,10,0
"834","Felix Afena-Gyan",205,4,2,3,1,0,1,1,NA,0,0,0,0,0,4,1,0
"835","Felix Agu",49,1,0,0,1,0,0,0,NA,0,1,1,0,0,1,0,0
"836","Felix Kalu Nmecha",665,12,7,3,6,3,3,7,NA,4,5,3,2,8,20,13,0
"837","Felix Passlack",139,4,1,1,2,1,2,2,NA,0,2,0,2,0,4,2,0
"838","Félix Torres Caicedo",270,2,2,2,0,0,2,3,NA,1,3,2,1,4,6,10,0
"839","Ferjani Sassi",48,2,0,0,2,0,1,1,NA,0,1,0,1,1,3,0,0
"840","Ferland Mendy",1231,15,8,11,3,1,10,16,NA,6,6,2,4,13,28,13,0
"841","Fernand Mayembo",284,1,1,1,0,0,0,1,NA,1,1,0,1,3,4,18,0
"842","Fernando",1819,14,9,7,5,2,8,14,NA,6,11,1,10,11,25,19,0
"843","Fernando Calero",873,24,15,17,5,2,14,19,NA,5,22,8,14,8,32,29,0
"844","Fernando Pacheco",90,0,0,0,0,0,0,0,NA,0,0,0,0,0,0,1,0
"845","Ferrán Torres",866,7,4,0,4,3,3,11,NA,8,5,1,4,1,8,3,0
"846","Festy Ebosele",8,0,0,0,0,0,0,0,NA,0,0,0,0,0,0,0,0
"847","Fidel",165,1,1,1,0,0,0,3,NA,3,2,0,2,1,2,0,0
"848","Fikayo Tomori",1481,40,21,25,15,0,7,13,NA,6,21,9,12,16,56,43,0
"849","Filip Đuričić",921,18,10,9,7,2,5,10,NA,5,4,0,4,5,23,1,0
"850","Filip Kostić",1476,25,14,10,8,7,17,35,NA,18,15,2,13,7,32,11,0
"851","Filip Mladenović",65,0,0,0,0,0,0,2,0,2,1,0,1,0,0,1,0
"852","Filip Uremović",555,9,4,7,2,0,5,5,NA,0,6,5,1,15,24,31,2
"853","Filippo Bandinelli",901,20,12,6,9,5,3,11,NA,8,7,2,5,8,28,19,0
"854","Filippo Ranocchia",197,4,4,2,2,0,1,3,NA,2,1,0,1,3,7,0,0
"855","Filippo Terracciano",326,6,5,4,1,1,4,4,NA,0,3,2,1,2,8,3,0
"856","Finn Ole Becker",3,0,0,0,0,0,0,0,NA,0,0,0,0,0,0,0,0
"857","Firas Al-Buraikan",268,3,3,2,0,1,2,2,NA,0,5,2,3,2,5,4,0
"858","Fisnik Asllani",42,0,0,0,0,0,0,0,NA,0,1,0,1,2,2,0,0
"859","Flavien Tait",1044,21,13,7,11,3,13,28,NA,15,11,3,8,7,28,10,0
"860","Flávio Nazinho",120,3,2,3,0,0,0,2,NA,2,0,0,0,1,4,3,0
"861","Flavius Daniliuc",846,22,11,18,4,0,7,10,NA,3,16,6,10,10,32,35,0
"862","Florent Mollet",410,4,1,0,4,0,2,7,NA,5,7,1,6,1,5,1,0
"863","Florent Ogier",672,12,6,7,4,1,9,15,NA,6,14,8,6,5,17,17,1
"864","Florentino Luís",526,18,12,5,13,0,7,18,NA,11,5,0,5,19,37,8,0
"865","Florian Dietz",395,2,1,0,2,0,1,4,NA,3,4,1,3,0,2,2,0
"866","Florian Flick",512,12,3,7,5,0,4,14,NA,10,9,3,6,4,16,18,0
"867","Florian Grillitsch",59,1,1,1,0,0,1,6,NA,5,1,0,1,0,1,0,0
"868","Florian Kainz",1031,8,4,4,4,0,4,9,NA,5,10,2,8,11,19,11,0
"869","Florian Lejeune",948,8,5,5,2,1,5,9,NA,4,9,7,2,6,14,37,0
"870","Florian Müller",1350,0,0,0,0,0,0,0,NA,0,0,0,0,0,0,6,3
"871","Florian Neuhaus",468,4,0,2,1,1,2,7,NA,5,8,2,6,5,9,2,0
"872","Florian Niederlechner",910,10,5,5,4,1,4,7,NA,3,16,2,14,1,11,9,0
"873","Florian Sotoca",1234,15,6,5,5,5,6,14,NA,8,20,1,19,18,33,11,0
"874","Florian Tardieu",877,28,18,17,11,0,12,26,NA,14,16,3,13,23,51,14,0
"875","Flynn Downes",265,3,2,0,2,1,1,3,NA,2,9,0,9,1,4,1,0
"876","Fodé Ballo-Touré",331,7,3,2,5,0,4,5,NA,1,7,4,3,6,13,2,0
"877","Folarin Balogun",1076,4,2,0,3,1,0,6,NA,6,9,0,9,1,5,10,0
"878","Fortune Bassey",134,0,0,0,0,0,0,2,NA,2,0,0,0,0,0,0,0
"879","Fran Beltrán",1123,10,6,4,4,2,3,16,NA,13,11,2,9,14,24,7,1
"880","Fran Delgado",12,0,0,0,0,0,0,0,NA,0,0,0,0,0,0,0,0
"881","Fran Karačić",74,1,1,1,0,0,0,0,NA,0,1,0,1,2,3,3,0
"882","Francesco Acerbi",861,10,4,10,0,0,4,5,NA,1,6,3,3,7,17,36,0
"883","Francesco Caputo",1004,3,1,0,0,3,0,3,NA,3,0,0,0,1,4,3,0
"884","Francis Coquelin",523,14,9,6,6,2,6,6,NA,0,7,2,5,6,20,6,0
"885","Francisco Calvo",180,7,4,6,1,0,4,7,108.3,3,3,1,2,2,9,2,0
"886","Francisco Conceição",17,0,0,0,0,0,0,0,NA,0,1,0,1,0,0,1,0
"887","Francisco Garcia",1259,20,14,14,3,3,12,25,NA,13,14,1,13,16,36,21,0
"888","Francisco Perez",21,0,0,0,0,0,0,0,NA,0,0,0,0,0,0,0,0
"889","Francisco Portillo",201,3,2,1,1,1,0,3,NA,3,1,1,0,2,5,2,0
"890","Francisco Trincão",386,5,4,1,4,0,2,4,NA,2,3,0,3,2,7,3,0
"891","Franck Honorat",1162,23,15,11,6,6,9,21,NA,12,8,1,7,10,33,6,0
"892","Franck Kessié",490,9,4,3,5,1,3,6,NA,3,7,1,6,3,12,1,0
"893","Franck Ribéry",37,0,0,0,0,0,0,0,NA,0,1,0,1,0,0,0,0
"894","Franco Cervi",1017,36,19,11,20,5,15,35,NA,20,20,1,19,20,56,7,0
"895","Franco Israel",155,0,0,0,0,0,0,0,NA,0,0,0,0,0,0,0,1
"896","Franco Russo",77,1,1,1,0,0,0,1,NA,1,4,0,4,2,3,4,0
"897","François-Joseph Sollacaro",90,0,0,0,0,0,0,0,NA,0,0,0,0,0,0,1,0
"898","Frank Onyeka",442,13,9,7,5,1,7,12,NA,5,8,2,6,5,18,7,0
"899","Frank Tsadjout",28,0,0,0,0,0,0,0,NA,0,1,0,1,0,0,0,0
"900","Frantzdy Pierrot",481,3,1,1,1,1,0,1,NA,1,3,1,2,1,4,8,0
"901","Fred",471,10,8,3,5,2,2,9,NA,7,13,1,12,8,18,5,0
"902","Frederik Rønnow",990,0,0,0,0,0,0,1,NA,1,0,0,0,0,0,5,0
"903","Frederik Winther",90,2,2,1,1,0,0,2,0,2,1,1,0,0,2,7,0
"904","Fredrik Aursnes",260,9,6,3,4,2,3,4,NA,1,3,1,2,1,10,2,0
"905","Fredrik Jensen",617,8,7,4,2,2,3,5,NA,2,8,5,3,3,11,9,0
"906","Frenkie de Jong",1402,35,17,9,18,8,12,19,NA,7,14,4,10,22,57,9,1
"907","Gabriel Dos Santos",1260,19,13,11,6,2,8,12,NA,4,20,12,8,12,31,53,2
"908","Gabriel Gudmundsson",95,3,2,0,2,1,1,1,NA,0,0,0,0,2,5,0,0
"909","Gabriel Jesus",1249,20,16,9,5,6,7,16,NA,9,15,2,13,9,29,10,1
"910","Gabriel Paulista",579,9,5,7,2,0,7,11,NA,4,8,5,3,8,17,28,0
"911","Gabriel Strefezza",817,17,6,8,7,2,9,17,NA,8,9,2,7,6,23,9,0
"912","Gabriel Veiga",577,18,7,5,13,0,7,16,NA,9,7,0,7,5,23,3,0
"913","Gabriel Veron",47,1,0,1,0,0,1,1,NA,0,2,0,2,0,1,0,0
"914","Gabriel Vidovic",19,0,0,0,0,0,0,0,NA,0,0,0,0,0,0,0,0
"915","Gaël Kakuta",22,0,0,0,0,0,0,0,NA,0,0,0,0,0,0,1,0
"916","Gaël Ondoua",47,2,1,0,2,0,1,1,NA,0,1,0,1,2,4,0,0
"917","Gaëtan Charbonnier",254,2,1,0,2,0,0,4,NA,4,2,0,2,0,2,5,0
"918","Gaëtan Laborde",983,12,7,4,6,2,5,9,NA,4,11,1,10,3,15,8,0
"919","Gaëtan Perrin",440,5,1,0,3,2,3,11,NA,8,3,0,3,3,8,5,0
"920","Galeno",423,3,1,2,1,0,2,4,NA,2,13,3,10,9,12,4,0
"921","Garang Kuol",18,0,0,0,0,0,0,0,NA,0,0,0,0,1,1,0,0
"922","Gareth Bale",225,1,1,1,0,0,0,2,NA,2,1,0,1,1,2,1,0
"923","Gary Medel",983,16,10,11,4,1,7,13,NA,6,10,7,3,18,34,29,0
"924","Gastón Álvarez",429,11,8,8,3,0,6,12,NA,6,5,3,2,9,20,15,0
"925","Gauthier Gallon",1080,1,1,1,0,0,1,2,NA,1,0,0,0,2,3,5,0
"926","Gauthier Hein",669,13,9,6,6,1,7,16,NA,9,4,0,4,4,17,4,0
"927","Gavi",1287,26,19,5,15,6,9,18,NA,9,15,2,13,14,40,8,0
"928","Gavin Bazunu",1350,1,0,1,0,0,1,1,NA,0,0,0,0,1,2,13,0
"929","Gedeon Kalulu",1080,28,12,19,7,2,14,22,700.1,8,11,2,9,15,43,35,0
"930","Gelson Martins",111,3,2,0,1,2,0,3,NA,3,2,1,1,0,3,1,0
"931","Genki Haraguchi",362,8,5,1,7,0,3,6,NA,3,5,1,4,3,11,5,0
"932","Geoffrey Kondogbia",944,34,16,16,16,2,16,23,NA,7,10,1,9,25,59,12,1
"933","Georges-Kévin N'Koudou",27,0,0,0,0,0,0,0,NA,0,0,0,0,0,0,0,0
"934","Georginio Rutter",1009,7,4,1,4,2,1,3,NA,2,10,2,8,5,12,6,0
"935","Georginio Wijnaldum",13,0,0,0,0,0,0,0,NA,0,0,0,0,0,0,0,0
"936","Gerard Deulofeu",1110,7,4,4,1,2,5,13,NA,8,6,1,5,2,9,1,0
"937","Gerard Gumbau",831,12,7,4,7,1,3,10,NA,7,11,5,6,6,18,14,0
"938","Gerard Moreno",382,4,3,0,3,1,1,2,NA,1,3,1,2,1,5,2,0
"939","Gerard Piqué",642,8,6,1,7,0,5,6,NA,1,5,3,2,5,13,27,0
"940","Gerard Yepes",198,5,3,2,3,0,1,3,NA,2,3,0,3,4,9,3,0
"941","Germán Pezzella",923,17,11,13,4,0,10,12,NA,2,12,5,7,22,39,40,1
"942","Gerónimo Rulli",1260,0,0,0,0,0,0,0,NA,0,1,0,1,1,1,6,2
"943","Gerrit Holtmann",736,10,6,5,4,1,8,11,NA,3,14,1,13,2,12,2,0
"944","Gerson",538,7,5,2,4,1,3,5,NA,2,7,0,7,2,9,4,0
"945","Gerson Torres",64,0,0,0,0,0,0,2,0,2,1,0,1,0,0,0,0
"946","Gerzino Nyamsi",657,7,5,4,3,0,4,4,NA,0,6,5,1,6,13,22,0
"947","Ghaylène Chaalali",17,0,0,0,0,0,0,0,NA,0,1,0,1,2,2,1,0
"948","Ghjuvanni Quilichini",82,0,0,0,0,0,0,0,NA,0,0,0,0,0,0,1,0
"949","Giacomo Bonaventura",840,17,11,7,7,3,10,15,600,5,7,0,7,9,26,2,0
"950","Giacomo Quagliata",346,6,6,5,0,1,3,4,NA,1,5,2,3,4,10,3,0
"951","Giacomo Raspadori",707,8,7,0,5,3,1,4,NA,3,5,0,5,3,11,3,0
"952","Gian Marco Ferrari",1168,11,7,7,4,0,6,9,NA,3,12,9,3,12,23,44,1
"953","Giangiacomo Magnani",93,1,0,1,0,0,0,0,NA,0,2,2,0,1,2,3,0
"954","Gianluca Caprari",833,7,4,2,4,1,3,7,NA,4,5,1,4,2,9,0,0
"955","Gianluca Gaetano",63,2,1,0,2,0,0,0,NA,0,0,0,0,0,2,0,0
"956","Gianluca Mancini",1083,16,10,12,4,0,6,8,NA,2,10,5,5,15,31,23,0
"957","Gianluca Scamacca",755,8,3,1,3,4,2,2,NA,0,3,0,3,2,10,4,0
"958","Gianluigi Donnarumma",1890,0,0,0,0,0,0,0,NA,0,0,0,0,0,0,9,1
"959","Gideon Mensah",717,19,9,10,7,2,12,18,NA,6,9,4,5,16,35,15,0
"960","Gilberto",38,3,3,3,0,0,2,2,NA,0,0,0,0,2,5,2,0
"961","Gio Reyna",672,9,5,2,5,2,4,9,NA,5,6,2,4,4,13,3,1
"962","Giorgi Mamardashvili",1260,0,0,0,0,0,0,0,NA,0,0,0,0,0,0,8,1
"963","Giorgian De Arrascaeta",29,0,0,0,0,0,0,1,0,1,0,0,0,1,1,0,0
"964","Giorgio Scalvini",557,18,8,7,6,5,13,18,NA,5,12,3,9,11,29,13,1
"965","Giorgos Giakoumakis",246,4,3,1,0,3,0,2,NA,2,5,0,5,4,8,3,0
"966","Giorgos Kyriakopoulos",691,20,8,7,8,5,10,12,NA,2,6,0,6,11,31,10,0
"967","Giovani Lo Celso",521,21,17,3,13,5,8,12,550,4,6,0,6,5,26,3,0
"968","Giovanni Di Lorenzo",1686,33,18,16,15,2,12,21,NA,9,17,4,13,20,53,41,0
"969","Giovanni González",344,4,3,3,1,0,3,8,NA,5,2,1,1,3,7,8,0
"970","Giovanni Simeone",377,9,4,1,5,3,2,4,NA,2,2,0,2,1,10,2,0
"971","Giulian Biancone",17,2,1,2,0,0,1,1,NA,0,0,0,0,1,3,0,0
"972","Giulio Donati",65,3,1,2,0,1,2,2,NA,0,1,1,0,3,6,1,0
"973","Giulio Maggiore",653,14,6,6,5,3,7,14,NA,7,17,4,13,8,22,4,0
"974","Giuseppe Pezzella",434,10,5,8,0,2,6,11,NA,5,5,2,3,5,15,16,1
"975","Gleison Bremer",1214,14,7,11,2,1,7,11,NA,4,23,14,9,25,39,50,1
"976","Glen Kamara",127,0,0,0,0,0,0,1,NA,1,2,1,1,4,4,1,1
"977","Gonçalo Borges",38,1,0,1,0,0,0,0,NA,0,0,0,0,0,1,0,0
"978","Gonçalo Guedes",689,7,5,3,3,1,4,7,NA,3,4,0,4,1,8,2,0
"979","Gonçalo Inácio",540,4,1,4,0,0,2,6,NA,4,7,3,4,5,9,21,0
"980","Gonçalo Paciência",331,5,3,0,4,1,1,3,NA,2,4,1,3,0,5,2,0
"981","Gonçalo Ramos",407,8,4,0,5,3,0,3,NA,3,4,0,4,0,8,4,0
"982","Gonzalo Escalante",555,16,8,8,8,0,10,13,NA,3,7,1,6,10,26,4,0
"983","Gonzalo Melero",536,13,5,2,8,3,3,7,NA,4,4,0,4,2,15,8,0
"984","Gonzalo Montiel",873,14,8,4,10,0,9,14,NA,5,11,4,7,12,26,14,1
"985","Gonzalo Plata",861,15,10,8,5,2,6,18,NA,12,8,0,8,6,21,2,0
"986","Gonzalo Verdú",388,4,1,4,0,0,2,4,NA,2,7,6,1,4,8,17,0
"987","Gonzalo Villar",594,13,7,4,8,1,7,14,NA,7,11,3,8,4,17,9,1
"988","Gorka Guruzeta",203,2,2,2,0,0,1,3,NA,2,1,0,1,1,3,0,0
"989","Granit Xhaka",1346,13,10,6,7,0,7,13,NA,6,12,5,7,7,20,28,1
"990","Greg Taylor",540,14,9,4,7,3,9,12,NA,3,8,4,4,7,21,6,0
"991","Grégoire Defrel",126,0,0,0,0,0,0,0,NA,0,0,0,0,0,0,1,0
"992","Gregor Kobel",1215,0,0,0,0,0,0,0,NA,0,0,0,0,0,0,5,1
"993","Grejohn Kyei",596,4,0,1,2,1,2,3,NA,1,4,1,3,1,5,4,0
"994","Grigoris Kastanos",261,10,5,1,7,2,2,8,NA,6,5,2,3,2,12,1,0
"995","Grischa Prömel",1071,23,18,12,9,2,7,17,NA,10,16,3,13,5,28,17,0
"996","Grzegorz Krychowiak",262,8,4,2,5,1,1,6,33.3,5,3,2,1,3,11,3,0
"997","Guglielmo Vicario",1170,0,0,0,0,0,0,1,NA,1,0,0,0,0,0,8,2
"998","Guido Rodríguez",1099,40,25,16,20,4,19,30,NA,11,20,7,13,13,53,25,0
"999","Guillermo Maripán",765,15,8,9,6,0,2,9,NA,7,14,10,4,13,28,25,0
"1000","Guillermo Ochoa",270,0,0,0,0,0,0,0,NA,0,0,0,0,0,0,0,0
"1001","Guillermo Varela",93,0,0,0,0,0,0,1,NA,1,0,0,0,1,1,0,0
"1002","Habib Diallo",1131,6,3,1,3,2,2,5,NA,3,7,0,7,6,12,3,0
"1003","Haji Wright",113,1,0,1,0,0,1,1,NA,0,0,0,0,0,1,1,0
"1004","Hakan Çalhanoğlu",1359,36,20,12,19,5,9,24,NA,15,22,5,17,17,53,8,1
"1005","Hakim Ziyech",390,13,7,7,5,1,3,4,NA,1,8,0,8,5,18,3,0
"1006","Hákon Arnar Haraldsson",298,5,3,2,2,1,1,2,NA,1,1,0,1,0,5,1,0
"1007","Halid Šabanović",258,3,2,3,0,0,3,5,NA,2,4,1,3,3,6,3,0
"1008","Halil Dervişoğlu",8,0,0,0,0,0,0,0,NA,0,0,0,0,0,0,0,0
"1009","Hamari Traoré",1183,21,14,9,11,1,11,23,NA,12,16,4,12,19,40,36,0
"1010","Hamed Junior Traorè",179,2,0,2,0,0,1,4,NA,3,2,0,2,0,2,0,1
"1011","Hamza Sakhi",1194,37,21,17,15,5,18,33,NA,15,7,1,6,16,53,8,0
"1012","Hannes Wolf",53,3,1,2,1,0,2,3,NA,1,1,0,1,0,3,5,0
"1013","Hannibal Mejbri",11,1,0,1,0,0,0,0,NA,0,0,0,0,1,2,0,0
"1014","Hans Hateboer",959,13,8,7,5,1,9,21,NA,12,16,4,12,7,20,18,0
"1015","Hans Vanaken",540,5,3,2,2,1,2,5,NA,3,7,2,5,1,6,11,0
"1016","Haris Belkebla",1087,34,21,14,16,4,20,30,NA,10,15,2,13,23,57,7,2
"1017","Haris Seferović",34,0,0,0,0,0,0,0,NA,0,0,0,0,0,0,0,0
"1018","Harrison Reed",1175,17,11,5,10,2,8,20,NA,12,19,3,16,11,28,20,0
"1019","Harry Kane",2097,7,5,1,3,3,2,8,NA,6,13,4,9,3,10,11,0
"1020","Harry Maguire",530,4,2,4,0,0,2,3,NA,1,14,9,5,7,11,26,0
"1021","Harry Souttar",270,2,0,2,0,0,0,0,NA,0,7,4,3,3,5,20,0
"1022","Harry Toffolo",577,8,6,4,2,2,3,5,NA,2,6,2,4,6,14,20,0
"1023","Harry Wilson",428,7,4,2,4,1,3,3,NA,0,6,0,6,2,9,4,0
"1024","Harvey Barnes",1086,11,8,6,3,2,6,13,NA,7,13,0,13,2,13,4,0
"1025","Harvey Elliott",1214,16,8,6,6,4,5,21,NA,16,20,1,19,7,23,9,0
"1026","Hassan Al-Haydos",206,4,1,2,2,0,2,8,70,6,0,0,0,2,6,1,0
"1027","Hassan Al Tambakti",180,4,2,3,1,0,3,4,166.7,1,3,2,1,3,7,6,0
"1028","Hattan Bahebri",4,0,0,0,0,0,0,0,NA,0,0,0,0,0,0,0,0
"1029","Héctor Bellerín",323,6,3,1,4,1,4,6,NA,2,5,2,3,4,10,3,0
"1030","Héctor Herrera",160,4,3,2,2,0,2,4,100,2,1,0,1,3,7,0,0
"1031","Héctor Moreno",270,2,1,2,0,0,1,1,NA,0,2,1,1,1,3,4,0
"1032","Helibelton Palacios",705,12,7,8,4,0,6,9,NA,3,8,3,5,7,19,22,0
"1033","Henning Matriciani",696,17,9,12,3,2,8,16,500,8,8,4,4,8,25,21,0
"1034","Henrikh Mkhitaryan",1039,21,13,10,8,3,7,15,NA,8,13,3,10,11,32,9,0
"1035","Henrique",130,4,1,1,0,3,3,5,166.7,2,1,0,1,1,5,2,0
"1036","Henrique Araújo",9,0,0,0,0,0,0,0,NA,0,0,0,0,0,0,0,0
"1037","Henry Martín",146,1,1,1,0,0,1,2,NA,1,2,0,2,2,3,1,0
"1038","Heorhii Sudakov",480,9,6,7,1,1,4,7,NA,3,1,0,1,6,15,5,1
"1039","Hernán Galíndez",270,0,0,0,0,0,0,0,NA,0,0,0,0,0,0,0,0
"1040","Hianga Mananga Mbock",15,0,0,0,0,0,0,1,NA,1,0,0,0,0,0,0,0
"1041","Hicham Boudaoui",362,18,6,9,7,2,11,12,NA,1,6,0,6,4,22,2,0
"1042","Hidemasa Morita",421,5,1,3,1,1,1,1,NA,0,3,1,2,2,7,3,0
"1043","Himad Abdelli",231,5,0,0,5,0,3,3,NA,0,0,0,0,3,8,2,0
"1044","Hiroki Ito",1121,15,13,9,4,2,8,17,NA,9,13,4,9,16,31,37,0
"1045","Hiroki Sakai",73,4,3,2,1,1,2,3,66.7,1,1,1,0,1,5,5,0
"1046","Hirving Lozano",1119,18,6,6,8,4,8,15,NA,7,18,0,18,4,22,6,0
"1047","Homam Ahmed",262,2,2,2,0,0,1,3,NA,2,0,0,0,2,4,1,0
"1048","Hossein Hosseini",161,0,0,0,0,0,0,0,NA,0,0,0,0,0,0,0,0
"1049","Hossein Kanaanizadegan",45,0,0,0,0,0,0,2,0,2,1,1,0,1,1,2,0
"1050","Houboulang Mendes",498,9,6,8,1,0,4,12,250,8,7,1,6,3,12,16,0
"1051","Houssem Aouar",343,8,3,3,3,2,2,4,NA,2,8,0,8,4,12,1,0
"1052","Hrvoje Smolčić",233,4,3,3,1,0,2,2,NA,0,9,1,8,5,9,20,0
"1053","Hugo Bueno",451,14,7,13,1,0,9,16,NA,7,4,0,4,5,19,20,0
"1054","Hugo Duro",391,5,2,1,1,3,4,5,NA,1,1,0,1,0,5,3,1
"1055","Hugo Ekitike",280,3,2,0,2,1,1,4,NA,3,1,0,1,2,5,1,0
"1056","Hugo Guillamón",916,9,4,4,5,0,2,12,NA,10,8,1,7,10,19,9,2
"1057","Hugo Lloris",2070,1,1,1,0,0,1,1,NA,0,0,0,0,1,2,11,2
"1058","Hugo Magnetti",590,23,14,10,12,1,17,29,NA,12,4,1,3,8,31,7,0
"1059","Hugo Mallo",873,19,8,12,5,2,13,19,NA,6,10,1,9,6,25,24,0
"1060","Hugo Novoa",187,8,2,1,3,4,4,7,NA,3,4,0,4,1,9,0,0
"1061","Hugo Siquet",17,2,2,2,0,0,2,2,200,0,1,0,1,0,2,0,0
"1062","Hwang Hee-chan",325,3,2,1,1,1,2,4,NA,2,3,0,3,0,3,1,0
"1063","Hwang In-beom",180,2,1,0,1,1,1,2,100,1,0,0,0,2,4,1,0
"1064","Hwang Ui-jo",85,0,0,0,0,0,0,0,NA,0,0,0,0,0,0,1,0
"1065","Iago",1088,21,9,15,3,3,6,15,NA,9,8,2,6,9,30,38,0
"1066","Iago Aspas",1122,0,0,0,0,0,0,5,NA,5,5,0,5,4,4,9,0
"1067","Ibrahim Amadou",401,9,6,5,3,1,7,10,483.3,3,6,3,3,8,17,18,0
"1068","Ibrahim Diakité",131,3,3,3,0,0,2,3,NA,1,0,0,0,5,8,6,0
"1069","Ibrahim Sulemana",44,1,1,0,0,1,0,1,NA,1,0,0,0,0,1,0,0
"1070","Ibrahima Diallo",450,10,5,5,4,1,5,7,NA,2,6,0,6,2,12,6,0
"1071","Ibrahima Konaté",476,18,9,13,5,0,4,5,NA,1,5,3,2,6,24,26,0
"1072","Ibrahima Koné",304,1,0,0,1,0,1,2,NA,1,2,0,2,1,2,2,0
"1073","Ibrahima Sissoko",225,4,2,2,1,1,2,5,NA,3,3,0,3,0,4,2,0
"1074","Iddrisu Baba",547,15,6,6,9,0,6,11,NA,5,4,0,4,4,19,10,0
"1075","Idrissa Gana Gueye",1008,27,17,16,8,3,8,18,NA,10,22,3,19,25,52,13,1
"1076","Iglesias",1026,34,18,23,8,3,17,31,NA,14,18,5,13,8,42,36,0
"1077","Ignacio Pussetto",152,6,3,2,3,1,3,4,NA,1,4,0,4,0,6,3,0
"1078","Ignatius Ganago",569,4,3,1,2,1,1,2,NA,1,5,0,5,0,4,1,0
"1079","Igor",676,12,5,6,3,3,3,7,NA,4,12,5,7,8,20,16,1
"1080","Igor Zubeldia",717,12,6,7,5,0,6,7,NA,1,9,6,3,7,19,33,0
"1081","Ike Ugbo",386,4,1,1,2,1,3,5,NA,2,6,1,5,1,5,2,0
"1082","Iker Muniain",788,6,4,0,5,1,1,3,NA,2,2,0,2,3,9,1,0
"1083","Ilaix Moriba",331,8,5,2,3,3,4,5,NA,1,3,0,3,2,10,6,0
"1084","Ilia Gruev",713,18,10,9,8,1,9,16,NA,7,12,4,8,10,28,8,1
"1085","Ilija Nestorovski",93,1,0,0,0,1,1,2,NA,1,2,0,2,0,1,2,0
"1086","Iliman Ndiaye",90,0,0,0,0,0,0,2,NA,2,1,0,1,0,0,0,0
"1087","İlkay Gündoğan",1438,19,10,2,9,8,10,15,NA,5,12,2,10,12,31,7,0
"1088","Illan Meslier",1260,1,0,1,0,0,1,2,NA,1,0,0,0,1,2,10,0
"1089","Ilyes Cheti",58,1,0,0,0,1,0,1,NA,1,1,0,1,0,1,3,0
"1090","Iñaki Peña",90,0,0,0,0,0,0,0,NA,0,0,0,0,0,0,0,0
"1091","Iñaki Williams",1320,12,7,1,9,2,4,4,NA,0,5,2,3,2,14,13,0
"1092","Íñigo Eguaras",495,7,6,3,4,0,3,8,NA,5,7,3,4,4,11,9,0
"1093","Iñigo Lekue",947,15,9,11,4,0,5,10,NA,5,10,1,9,12,27,22,1
"1094","Iñigo Martínez",810,8,3,6,2,0,2,4,NA,2,9,5,4,14,22,31,0
"1095","Iñigo Ruiz de Galarreta",854,23,17,13,8,2,6,12,NA,6,7,3,4,11,34,9,0
"1096","Ionuț Radu",810,0,0,0,0,0,0,0,NA,0,0,0,0,0,0,1,3
"1097","Irvin Cardona",233,2,0,1,1,0,0,3,NA,3,3,0,3,2,4,2,0
"1098","Isaac Carcelen",452,19,14,17,1,1,12,12,700,0,7,3,4,5,24,15,0
"1099","Isaac Palazón Camacho",986,19,14,6,9,4,8,19,NA,11,8,0,8,4,23,8,0
"1100","Isaac Success",733,4,2,1,2,1,1,2,NA,1,4,2,2,2,6,10,0
"1101","Isak Hien",746,25,10,18,7,0,12,17,NA,5,6,3,3,11,36,19,0
"1102","Ísak Jóhannesson",290,4,0,2,1,1,3,4,NA,1,5,0,5,2,6,3,0
"1103","Isco",1198,21,12,9,8,4,11,25,NA,14,5,0,5,15,36,4,0
"1104","Islam Slimani",831,3,2,1,2,0,0,2,NA,2,2,0,2,1,4,10,0
"1105","Ismaël Bennacer",1406,47,24,22,21,4,19,28,NA,9,12,4,8,18,65,9,1
"1106","Ismael Diallo",926,14,9,12,2,0,9,16,NA,7,8,2,6,8,22,21,1
"1107","Ismaël Doukouré",409,4,1,1,3,0,0,1,NA,1,5,2,3,3,7,12,0
"1108","Ismaël Koné",78,0,0,0,0,0,0,1,NA,1,0,0,0,0,0,0,0
"1109","Ismaëlben Boura",68,3,1,3,0,0,3,4,NA,1,2,1,1,2,5,2,0
"1110","Ismail Jakobs",535,3,2,3,0,0,1,3,NA,2,4,0,4,4,7,16,0
"1111","Ismail Mohamad",174,NA,2,NA,NA,NA,NA,NA,NA,NA,NA,NA,NA,2,NA,NA,NA
"1112","Ismaila Sarr",254,4,2,1,2,1,2,3,NA,1,2,0,2,2,6,1,0
"1113","Ismaily",920,23,8,9,11,3,10,15,NA,5,13,2,11,12,35,21,0
"1114","Issa Diop",598,8,6,5,2,1,5,6,NA,1,5,4,1,3,11,18,0
"1115","Issa Kaboré",479,16,11,5,8,3,10,15,NA,5,5,0,5,3,19,7,1
"1116","Issam Jebali",182,3,3,1,1,1,0,1,NA,1,1,0,1,0,3,3,0
"1117","Issiaga Sylla",1049,23,14,12,7,4,12,27,NA,15,10,4,6,25,48,23,0
"1118","Iván Alejo",657,22,15,11,7,4,13,26,NA,13,12,1,11,2,24,5,1
"1119","Iván Balliu",1260,17,11,9,8,0,4,7,NA,3,7,1,6,13,30,36,1
"1120","Iván Fresneda",468,15,10,6,8,1,9,12,NA,3,5,1,4,8,23,18,0
"1121","Ivan Ilić",646,10,6,4,6,0,4,8,NA,4,8,0,8,6,16,10,0
"1122","Iván Marcano",90,1,0,1,0,0,1,1,100,0,1,1,0,1,2,5,0
"1123","Iván Martín",103,1,1,0,1,0,1,1,NA,0,0,0,0,0,1,0,0
"1124","Ivan Ordets",1036,17,12,13,4,0,9,13,NA,4,12,6,6,20,37,55,0
"1125","Ivan Perišić",1437,31,15,16,10,5,18,37,NA,19,22,7,15,15,46,26,2
"1126","Ivan Petryak",180,2,2,0,2,0,0,0,NA,0,3,0,3,0,2,1,0
"1127","Ivan Provedel",1073,0,0,0,0,0,0,0,NA,0,0,0,0,0,0,11,0
"1128","Ivan Radovanović",391,7,2,3,4,0,2,5,NA,3,7,3,4,5,12,7,0
"1129","Ivan Rakitić",943,19,11,5,8,6,8,21,NA,13,11,2,9,13,32,12,0
"1130","Iván Romero",11,0,0,0,0,0,0,0,NA,0,0,0,0,0,0,0,0
"1131","Iván Sánchez",555,7,5,3,1,3,5,12,NA,7,6,0,6,1,8,0,0
"1132","Ivan Šunjić",843,30,15,13,16,1,12,20,NA,8,13,4,9,11,41,18,1
"1133","Ivan Toney",1260,12,9,3,4,5,5,9,NA,4,10,2,8,5,17,16,0
"1134","Ivo Grbić",298,0,0,0,0,0,0,1,NA,1,0,0,0,0,0,3,0
"1135","Iyenoma Udogie",960,29,17,20,8,1,14,22,NA,8,8,3,5,13,42,8,0
"1136","Jacek Góralski",142,5,2,2,3,0,3,5,100,2,4,0,4,3,8,5,0
"1137","Jack Colback",147,6,5,3,3,0,2,3,NA,1,0,0,0,1,7,3,0
"1138","Jack Grealish",945,7,2,3,4,0,2,5,NA,3,6,0,6,6,13,1,0
"1139","Jack Harrison",937,17,7,1,7,9,3,16,NA,13,14,1,13,4,21,6,0
"1140","Jack Hendry",98,0,0,0,0,0,0,0,NA,0,1,1,0,1,1,4,0
"1141","Jack Stacey",134,4,4,3,1,0,2,3,NA,1,2,0,2,2,6,7,0
"1142","Jack Stephens",139,3,3,2,1,0,2,2,NA,0,3,3,0,1,4,4,0
"1143","Jackson Irvine",264,4,2,1,3,0,2,4,150,2,6,0,6,3,7,7,0
"1144","Jackson Porozo",1054,21,11,15,5,1,9,19,NA,10,12,8,4,23,44,50,0
"1145","Jacob Bruun Larsen",294,3,2,0,0,3,2,2,NA,0,2,0,2,1,4,0,0
"1146","Jacob Murphy",489,8,3,2,5,1,4,9,NA,5,6,0,6,1,9,2,0
"1147","Jacob Ramsey",1021,31,19,12,16,3,10,21,NA,11,28,5,23,13,44,8,0
"1148","Jacopo Fazzini",85,12,7,10,2,0,6,7,NA,1,2,1,1,2,14,5,0
"1149","Jacopo Sala",112,1,0,1,0,0,0,2,NA,2,2,0,2,1,2,2,0
"1150","Jacopo Segre",21,0,0,0,0,0,0,0,NA,0,0,0,0,0,0,0,0
"1151","Jadon Sancho",714,4,2,4,0,0,2,5,NA,3,6,0,6,4,8,1,0
"1152","Jaidon Anthony",272,6,3,2,4,0,3,9,NA,6,2,0,2,0,6,6,0
"1153","Jaime Báez",96,4,2,3,0,1,3,6,140,3,0,0,0,0,4,2,1
"1154","Jaime Mata",42,0,0,0,0,0,0,0,NA,0,1,0,1,0,0,0,0
"1155","Jaime Seoane",273,10,4,3,4,3,2,6,NA,4,3,2,1,1,11,2,0
"1156","Jaïro Riedewald",41,2,1,2,0,0,0,1,NA,1,1,0,1,0,2,2,0
"1157","Jaka Bijol",849,13,8,10,3,0,6,8,NA,2,16,9,7,11,24,64,0
"1158","Jakub Kamiński",960,18,12,7,7,4,6,14,NA,8,14,1,13,3,21,5,0
"1159","Jakub Kiwior",1468,18,13,12,6,0,7,23,NA,16,25,17,8,25,43,68,3
"1160","Jamaal Lascelles",107,1,0,1,0,0,1,1,NA,0,3,2,1,0,1,10,0
"1161","Jamal Lewis",8,0,0,0,0,0,0,0,NA,0,0,0,0,0,0,0,0
"1162","Jamal Lowe",1,0,0,0,0,0,0,0,NA,0,0,0,0,0,0,0,0
"1163","Jamal Musiala",1384,17,10,5,8,4,7,14,NA,7,17,2,15,11,28,4,0
"1164","James Forrest",90,1,1,0,1,0,0,1,NA,1,2,0,2,1,2,1,0
"1165","James Garner",142,6,5,1,4,1,1,4,NA,3,2,0,2,4,10,1,0
"1166","James Justin",1252,20,18,7,12,1,9,12,NA,3,24,6,18,15,35,47,0
"1167","James Maddison",1098,25,10,12,10,3,9,21,NA,12,7,0,7,9,34,5,0
"1168","James McCarthy",9,0,0,0,0,0,0,0,NA,0,0,0,0,0,0,1,0
"1169","James Milner",621,18,10,8,6,4,6,19,NA,13,8,2,6,8,26,9,0
"1170","James Sands",324,5,3,1,4,0,1,1,NA,0,2,1,1,4,9,9,0
"1171","James Tarkowski",1350,16,9,12,4,0,7,14,NA,7,46,38,8,24,40,79,2
"1172","James Tavernier",486,11,5,6,5,0,8,11,500,3,7,4,3,6,17,13,1
"1173","James Tomkins",48,1,0,1,0,0,1,1,100,0,0,0,0,0,1,2,0
"1174","James Ward-Prowse",1350,26,13,11,13,2,6,18,NA,12,8,1,7,20,46,15,0
"1175","Jamie Bynoe-Gittens",161,0,0,0,0,0,0,0,NA,0,0,0,0,0,0,0,0
"1176","Jamie Leweling",117,3,3,2,1,0,2,2,NA,0,1,0,1,1,4,0,0
"1177","Jamie Maclaren",36,0,0,0,0,0,0,3,NA,3,0,0,0,1,1,0,0
"1178","Jamie Vardy",751,5,2,2,1,2,1,2,NA,1,3,0,3,1,6,16,0
"1179","Jan Bednarek",250,5,4,1,4,0,1,1,NA,0,6,3,3,5,10,9,0
"1180","Jan Jakob Olschowsky",180,0,0,0,0,0,0,1,NA,1,0,0,0,0,0,1,0
"1181","Jan Kliment",45,0,0,0,0,0,0,1,0,1,0,0,0,0,0,1,0
"1182","Jan Kopic",81,1,1,1,0,0,1,3,NA,2,1,0,1,1,2,0,0
"1183","Jan Oblak",1502,0,0,0,0,0,0,0,NA,0,0,0,0,0,0,6,0
"1184","Jan Paul van Hecke",3,0,0,0,0,0,0,0,NA,0,0,0,0,0,0,0,0
"1185","Jan Sýkora",148,0,0,0,0,0,0,2,0,2,0,0,0,3,3,3,0
"1186","Jan Thielmann",489,8,7,3,4,1,2,6,NA,4,6,2,4,3,11,3,0
"1187","Jan Vertonghen",180,0,0,0,0,0,0,1,NA,1,2,2,0,3,3,8,0
"1188","Janik Haberer",848,10,6,4,6,0,6,16,NA,10,14,0,14,4,14,10,0
"1189","Janis Antiste",52,1,0,1,0,0,1,1,NA,0,0,0,0,0,1,0,0
"1190","Janis Blaswich",1068,0,0,0,0,0,0,0,NA,0,0,0,0,0,0,4,0
"1191","Jannes Horn",59,2,1,1,1,0,1,1,NA,0,1,0,1,3,5,2,0
"1192","Japhet Tanganga",18,1,1,1,0,0,1,1,100,0,0,0,0,0,1,0,0
"1193","Jarrod Bowen",1340,22,10,8,6,8,8,20,NA,12,20,5,15,11,33,9,0
"1194","Jason Berthomier",23,0,0,0,0,0,0,0,NA,0,0,0,0,0,0,0,0
"1195","Jason Cummings",35,0,0,0,0,0,0,0,NA,0,0,0,0,0,0,0,0
"1196","Jaume Costa",964,18,11,9,6,3,12,18,NA,6,6,2,4,4,22,15,0
"1197","Javi",365,5,3,4,0,1,3,4,NA,1,1,0,1,2,7,9,0
"1198","Javi Galán",1255,44,29,27,15,2,16,35,NA,19,20,1,19,8,52,14,0
"1199","Javi Puado",749,6,2,3,2,1,3,9,NA,6,2,0,2,3,9,4,0
"1200","Javi Sánchez",1003,14,8,9,5,0,4,7,NA,3,15,12,3,18,32,53,0
"1201","Javier Llabrés",17,0,0,0,0,0,0,0,NA,0,0,0,0,0,0,1,0
"1202","Javier Manquillo",11,1,0,1,0,0,1,1,100,0,0,0,0,0,1,0,0
"1203","Javier Pastore",5,0,0,0,0,0,0,0,NA,0,0,0,0,0,0,0,0
"1204","Jawad El Yamiq",451,7,3,6,1,0,2,2,NA,0,7,7,0,13,20,34,0
"1205","Jay Stansfield",87,0,0,0,0,0,0,2,NA,2,4,1,3,1,1,1,0
"1206","Jean-Charles Castelletto",1019,19,12,16,3,0,7,12,NA,5,11,6,5,24,43,37,0
"1207","Jean-Clair Todibo",NA,22,15,15,6,1,12,20,NA,8,15,7,8,9,31,46,0
"1208","Jean-Claude Billong",23,0,0,0,0,0,0,0,NA,0,1,1,0,1,1,0,0
"1209","Jean-Daniel Akpa-Akpro",137,3,3,3,0,0,1,1,NA,0,5,1,4,1,4,1,0
"1210","Jean-Eudes Aholou",590,13,8,3,8,2,5,12,NA,7,8,0,8,12,25,5,0
"1211","Jean-Kevin Duverne",1107,35,17,22,11,2,25,38,NA,13,13,1,12,8,43,26,0
"1212","Jean-Paul Boëtius",574,15,8,9,5,1,3,8,NA,5,12,0,12,6,21,5,0
"1213","Jean-Philippe Mateta",283,2,1,1,1,0,0,2,NA,2,1,1,0,1,3,7,0
"1214","Jean-Ricner Bellegarde",1297,23,11,10,9,4,4,12,NA,8,11,2,9,18,41,14,0
"1215","Jean-Victor Makengo",638,12,9,4,6,2,4,7,NA,3,6,2,4,8,20,2,0
"1216","Jean Lucas",291,9,5,3,5,1,6,12,NA,6,2,1,1,4,13,2,0
"1217","Jean Onana",148,4,1,2,2,0,1,3,NA,2,4,1,3,2,6,2,0
"1218","Jeff Reine-Adélaïde",313,7,4,1,4,2,5,8,NA,3,3,0,3,6,13,0,0
"1219","Jefferson Lerma",1350,19,12,9,7,3,8,14,NA,6,8,5,3,13,32,45,1
"1220","Jeffrey Gouweleeuw",1196,24,15,11,9,4,14,22,NA,8,14,9,5,25,49,62,1
"1221","Jeffrey Schlupp",1094,30,23,14,13,3,12,20,NA,8,18,5,13,12,42,12,0
"1222","Jeison Murillo",582,12,5,8,4,0,11,13,NA,2,11,7,4,4,16,22,0
"1223","Jens Cajuste",525,25,15,14,7,4,12,23,NA,11,13,3,10,9,34,12,0
"1224","Jens Stage",562,12,5,6,6,0,1,7,NA,6,11,4,7,11,23,11,0
"1225","Jeong Woo-yeong",513,5,2,2,2,1,2,3,NA,1,4,0,4,1,6,6,0
"1226","Jerdy Schouten",849,14,8,7,6,1,4,9,NA,5,22,11,11,12,26,19,1
"1227","Jere Uronen",221,8,5,4,4,0,7,11,NA,4,3,0,3,6,14,4,0
"1228","Jeremías Ledesma",1260,0,0,0,0,0,0,1,NA,1,1,0,1,2,2,9,1
"1229","Jérémie Bela",566,6,4,2,1,3,3,3,NA,0,6,1,5,6,12,7,0
"1230","Jeremie Boga",70,1,0,1,0,0,0,1,NA,1,2,0,2,0,1,0,0
"1231","Jeremie Frimpong",1549,34,16,15,15,4,18,31,NA,13,17,2,15,14,48,30,0
"1232","Jeremy Doku",170,5,4,0,4,1,4,7,NA,3,1,0,1,2,7,1,0
"1233","Jérémy Le Douaron",521,2,2,1,1,0,1,7,NA,6,7,1,6,1,3,3,0
"1234","Jeremy Sarmiento",93,2,1,0,1,1,0,1,NA,1,0,0,0,1,3,0,0
"1235","Jeremy Toljan",1229,19,15,9,9,1,9,10,NA,1,13,5,8,11,30,22,1
"1236","Jeroen Zoet",138,0,0,0,0,0,0,0,NA,0,0,0,0,0,0,0,0
"1237","Jérôme Boateng",291,2,0,1,1,0,1,3,NA,2,4,2,2,4,6,13,0
"1238","Jérôme Roussillon",22,0,0,0,0,0,0,0,NA,0,0,0,0,0,0,0,0
"1239","Jerry St. Juste",189,8,5,5,2,1,2,3,NA,1,2,0,2,7,15,6,0
"1240","Jesper Lindstrøm",1550,12,5,8,3,1,4,13,NA,9,22,0,22,8,20,8,0
"1241","Jesse Lingard",809,3,3,2,1,0,0,2,NA,2,9,0,9,4,7,4,0
"1242","Jesús Corona",62,1,0,1,0,0,0,0,NA,0,0,0,0,0,1,0,0
"1243","Jesús Gallardo",270,9,5,5,4,0,3,8,125,5,6,1,5,1,10,10,0
"1244","Jesús Navas",850,9,5,4,1,4,4,12,NA,8,11,4,7,8,17,17,0
"1245","Jesús Vallejo",18,2,2,1,0,1,2,2,100,0,1,1,0,0,2,2,0
"1246","Jesus Vazquez",148,4,4,2,0,2,0,1,NA,1,2,0,2,0,4,3,0
"1247","Jewison Bennette",86,0,0,0,0,0,0,0,NA,0,2,0,2,0,0,0,0
"1248","Jhegson Méndez",180,2,2,1,1,0,1,1,NA,0,4,0,4,1,3,1,0
"1249","Jhon Lucumí",830,19,13,12,7,0,7,14,NA,7,10,7,3,12,31,43,0
"1250","Jhon Mosquera",431,12,6,4,6,2,3,4,NA,1,3,2,1,4,16,8,0
"1251","Jim Allevinah",545,9,5,3,3,3,4,16,NA,12,9,0,9,1,10,2,0
"1252","Jimmy Cabot",511,20,12,10,8,2,12,26,NA,14,5,0,5,4,24,12,0
"1253","Jindřich Staněk",450,0,0,0,0,0,0,0,NA,0,0,0,0,0,0,2,0
"1254","Jiří Pavlenka",1288,0,0,0,0,0,0,3,NA,3,0,0,0,2,2,9,0
"1255","Joachim Andersen",1440,20,7,13,6,1,7,16,NA,9,16,9,7,13,33,104,0
"1256","Joakim Mæhle",964,23,12,8,6,9,16,24,NA,8,16,4,12,9,32,12,0
"1257","Joan Gonzàlez",1026,18,9,13,3,2,6,21,NA,15,16,3,13,8,26,18,0
"1258","Joan Jordán",944,15,9,5,8,2,7,18,NA,11,14,6,8,9,24,7,1
"1259","João Cancelo",1672,42,29,20,14,8,22,33,NA,11,8,1,7,20,62,16,1
"1260","João Félix",898,9,6,1,4,4,2,7,NA,5,1,0,1,3,12,2,0
"1261","João Mário",524,6,4,1,4,1,2,8,NA,6,4,0,4,2,8,5,0
"1262","João Mário Lopes",181,7,3,2,3,2,3,6,200,3,3,1,2,2,9,4,1
"1263","João Moutinho",997,29,16,19,7,3,11,30,NA,19,14,4,10,11,40,9,0
"1264","João Palhinha",1263,67,39,26,30,11,31,51,NA,20,22,2,20,14,81,22,1
"1265","Joaquín",160,1,1,0,1,0,0,1,NA,1,0,0,0,1,2,2,0
"1266","Joaquín Blázquez",90,0,0,0,0,0,0,0,NA,0,0,0,0,0,0,2,0
"1267","Joaquín Correa",563,7,4,2,3,2,1,3,NA,2,1,0,1,0,7,1,0
"1268","Joaquín Fernández",955,14,13,11,3,0,9,11,NA,2,17,12,5,12,26,44,1
"1269","Joaquin Sosa",160,2,1,2,0,0,1,2,NA,1,2,1,1,1,3,8,0
"1270","Jodel Dossou",255,7,4,3,2,2,4,4,NA,0,2,1,1,1,8,0,0
"1271","Joe Allen",94,1,1,1,0,0,1,2,100,1,1,0,1,1,2,4,0
"1272","Joe Aribo",944,28,19,13,11,4,10,16,NA,6,12,1,11,5,33,10,0
"1273","Joe Bryan",166,5,4,3,2,0,4,4,NA,0,2,0,2,1,6,1,0
"1274","Joe Gelhardt",169,3,1,1,0,2,1,3,NA,2,4,0,4,0,3,4,0
"1275","Joe Gomez",1113,25,17,14,9,2,12,16,NA,4,11,7,4,17,42,34,4
"1276","Joe Hart",540,0,0,0,0,0,0,0,NA,0,0,0,0,1,1,1,1
"1277","Joe Morrell",33,3,2,1,2,0,0,1,NA,1,2,0,2,1,4,0,0
"1278","Joe Rodon",1078,8,6,7,1,0,3,7,NA,4,11,9,2,9,17,45,1
"1279","Joe Rothwell",17,0,0,0,0,0,0,0,NA,0,1,0,1,0,0,0,0
"1280","Joe Scally",1300,21,14,16,5,0,16,20,NA,4,12,5,7,4,25,36,0
"1281","Joe Willock",1114,27,17,9,9,9,15,30,NA,15,23,4,19,12,39,10,0
"1282","Joe Worrall",717,20,9,11,7,2,8,12,NA,4,11,7,4,10,30,31,1
"1283","Joel Campbell",179,7,4,0,5,2,1,1,NA,0,2,0,2,0,7,2,0
"1284","Joël Matip",484,13,7,8,5,0,8,12,NA,4,2,1,1,6,19,20,0
"1285","Joel Pohjanpalo",4,0,0,0,0,0,0,0,NA,0,0,0,0,0,0,0,0
"1286","Joël Veltman",947,23,14,16,6,1,9,15,NA,6,16,5,11,11,34,31,0
"1287","Joel Ward",1021,19,15,14,3,2,10,11,NA,1,11,6,5,11,30,40,1
"1288","Joelinton",1060,33,21,17,11,5,15,29,NA,14,24,1,23,16,49,18,0
"1289","Johan Gastien",1213,30,16,14,15,1,17,52,NA,35,18,5,13,17,47,15,0
"1290","Johan Mojica",456,8,4,7,1,0,2,4,NA,2,4,2,2,6,14,7,0
"1291","Johan Vásquez",358,9,6,8,1,0,4,8,NA,4,7,5,2,6,15,20,1
"1292","Johann Lepenant",830,29,15,11,13,5,15,32,NA,17,12,2,10,13,42,10,0
"1293","John Donald",150,1,0,1,0,0,0,0,NA,0,2,2,0,5,6,3,1
"1294","John Lundstram",450,6,3,2,4,0,5,15,166.7,10,4,1,3,9,15,12,0
"1295","John McGinn",1056,38,24,17,17,4,20,33,NA,13,24,4,20,11,49,5,0
"1296","John Stones",1181,12,10,8,3,1,3,3,NA,0,8,4,4,6,18,18,0
"1297","Jon Karrikaburu",93,1,0,0,1,0,0,0,NA,0,2,0,2,0,1,0,0
"1298","Jon Magunacelaya",65,1,0,0,0,1,0,1,NA,1,0,0,0,0,1,1,0
"1299","Jon McLaughlin",90,0,0,0,0,0,0,1,0,1,0,0,0,0,0,0,0
"1300","Jon Moncayola",876,15,7,8,6,1,7,16,NA,9,10,1,9,1,16,9,0
"1301","Jon Morcillo",56,0,0,0,0,0,0,1,NA,1,0,0,0,1,1,0,0
"1302","Jon Pacheco",678,9,7,6,3,0,2,4,NA,2,3,3,0,6,15,20,0
"1303","Jonas Hector",1159,39,20,25,12,2,24,38,NA,14,18,3,15,19,58,33,0
"1304","Jonas Hofmann",1177,13,5,8,5,0,5,20,NA,15,15,2,13,7,20,8,0
"1305","Jonas Martin",156,6,5,4,2,0,4,11,NA,7,2,1,1,5,11,3,0
"1306","Jonas Omlin",806,1,0,1,0,0,0,0,NA,0,0,0,0,0,1,6,1
"1307","Jonas Wind",172,1,0,1,0,0,1,2,NA,1,0,0,0,0,1,3,0
"1308","Jonathan Bamba",1165,11,5,5,4,2,5,12,NA,7,15,0,15,12,23,5,0
"1309","Jonathan Burkardt",533,3,1,0,1,2,1,3,NA,2,6,1,5,1,4,1,0
"1310","Jonathan Clauss",1515,27,14,11,13,3,12,21,NA,9,13,1,12,17,44,21,1
"1311","Jonathan David",1399,11,9,2,7,2,5,10,NA,5,6,0,6,4,15,7,0
"1312","Jonathan Gradit",795,12,10,7,5,0,6,9,NA,3,9,5,4,11,23,22,0
"1313","Jonathan Ikone",746,8,1,2,3,3,1,1,NA,0,5,1,4,2,10,2,0
"1314","Jonathan Osorio",55,2,1,0,1,1,2,3,100,1,0,0,0,1,3,1,0
"1315","Jonathan Tah",1702,23,15,14,9,0,12,20,NA,8,18,10,8,17,40,83,0
"1316","Jonjo Shelvey",37,1,0,1,0,0,0,1,NA,1,1,0,1,0,1,0,0
"1317","Jonjoe Kenny",1350,30,21,16,12,2,14,27,NA,13,19,5,14,30,60,40,0
"1318","Jonny Castro",979,27,10,18,8,1,14,27,NA,13,19,3,16,11,38,21,1
"1319","Jonny Evans",810,10,4,10,0,0,6,9,NA,3,6,5,1,16,26,32,0
"1320","Jordan Amavi",193,3,2,3,0,0,1,3,NA,2,3,0,3,4,7,7,0
"1321","Jordan Ayew",995,34,22,13,12,9,6,17,NA,11,14,1,13,4,38,13,0
"1322","Jordan Ferri",1083,24,14,17,7,0,16,32,NA,16,8,3,5,6,30,8,0
"1323","Jordan Henderson",965,17,7,3,9,5,7,11,NA,4,10,2,8,11,28,6,0
"1324","Jordan Larsson",338,5,3,1,4,0,2,7,NA,5,8,0,8,3,8,3,0
"1325","Jordan Lotomba",931,18,10,12,5,1,14,17,NA,3,18,5,13,11,29,20,0
"1326","Jordan Morris",3,0,0,0,0,0,0,0,NA,0,0,0,0,0,0,0,0
"1327","Jordan Pefok",843,10,5,3,3,4,3,11,NA,8,11,4,7,3,13,9,0
"1328","Jordan Pickford",1530,0,0,0,0,0,0,0,NA,0,0,0,0,2,2,12,2
"1329","Jordan Veretout",1531,40,25,11,27,2,15,24,NA,9,12,4,8,19,59,21,2
"1330","Jordan Zemura",788,21,14,11,9,1,14,18,NA,4,13,3,10,10,31,18,0
"1331","Jordi Alba",972,17,12,9,8,0,10,18,NA,8,10,4,6,7,24,13,0
"1332","Jordi Masip",810,0,0,0,0,0,0,0,NA,0,0,0,0,0,0,3,0
"1333","Jordi Osei-Tutu",493,17,13,8,5,4,7,12,NA,5,10,4,6,4,21,6,0
"1334","Jorge Cuenca",95,0,0,0,0,0,0,0,NA,0,0,0,0,0,0,9,0
"1335","Jorge Eduardo Sánchez",444,11,4,7,3,1,8,12,NA,4,6,1,5,4,15,16,0
"1336","Jørgen Strand Larsen",690,3,1,1,1,1,1,8,NA,7,5,2,3,1,4,11,0
"1337","Jorginho",1321,42,22,21,16,5,23,43,NA,20,23,2,21,24,66,10,0
"1338","Joris Chotard",952,19,10,10,8,1,10,24,NA,14,16,6,10,15,34,14,0
"1339","Jorne Spileers",2,0,0,0,0,0,0,0,NA,0,0,0,0,0,0,4,0
"1340","Josan",392,5,5,5,0,0,3,5,NA,2,2,0,2,0,5,6,0
"1341","José Carlos Lazo",137,3,2,2,1,0,1,1,NA,0,0,0,0,2,5,5,0
"1342","José Cifuentes",59,2,2,1,1,0,0,2,0,2,1,0,1,0,2,1,0
"1343","José Fonte",1170,15,11,12,2,1,8,15,NA,7,20,10,10,10,25,47,2
"1344","José Luis Gayà",862,24,13,19,3,2,14,22,NA,8,12,5,7,11,35,19,0
"1345","José Luis Morales",424,3,2,1,0,2,3,5,NA,2,6,1,5,0,3,0,0
"1346","José Luis Palomino",90,4,1,3,1,0,3,3,100,0,0,0,0,2,6,1,0
"1347","José Mari",288,10,5,7,2,1,6,10,NA,4,2,1,1,5,15,4,0
"1348","José María Giménez",1316,23,12,17,6,0,13,22,NA,9,18,12,6,22,45,66,0
"1349","José Marsà",101,1,0,1,0,0,0,1,NA,1,1,0,1,1,2,6,0
"1350","José Pozo",75,1,1,0,1,0,0,0,NA,0,0,0,0,1,2,1,0
"1351","José Sá",1350,0,0,0,0,0,0,0,NA,0,0,0,0,0,0,6,0
"1352","Joseba Zaldúa",639,15,8,10,4,1,7,10,NA,3,4,2,2,11,26,22,0
"1353","Joselu",1260,3,1,1,0,2,1,3,NA,2,10,3,7,3,6,24,0
"1354","Joseph Aidoo",1260,26,17,17,8,1,8,12,NA,4,14,7,7,11,37,48,0
"1355","Joseph Hodge",79,3,1,0,2,1,1,2,NA,1,3,0,3,0,3,0,0
"1356","Josh Cohen",540,0,0,0,0,0,0,0,NA,0,0,0,0,0,0,2,0
"1357","Josh Dasilva",687,12,5,4,5,3,4,6,NA,2,8,3,5,2,14,3,0
"1358","Josh Doig",403,5,2,0,2,3,1,3,NA,2,6,2,4,5,10,1,0
"1359","Josh Onomah",15,1,0,1,0,0,0,0,NA,0,1,0,1,0,1,0,0
"1360","Josh Sargent",157,0,0,0,0,0,0,1,NA,1,1,0,1,1,1,0,0
"1361","Josh Wilson-Esbrand",46,1,1,1,0,0,1,1,NA,0,0,0,0,0,1,0,0
"1362","Josha Vagnoman",506,4,2,2,1,1,1,3,NA,2,6,2,4,6,10,15,0
"1363","Joshua Kimmich",1906,49,27,13,31,5,25,52,NA,27,21,3,18,33,82,25,0
"1364","Joshua Quarshie",1,0,0,0,0,0,0,0,NA,0,0,0,0,0,0,0,0
"1365","Joshua Zirkzee",165,1,0,0,0,1,0,1,NA,1,1,1,0,1,2,0,0
"1366","Josip Brekalo",271,2,1,2,0,0,0,4,NA,4,0,0,0,2,4,2,0
"1367","Josip Drmić",95,0,0,0,0,0,0,1,NA,1,0,0,0,0,0,2,0
"1368","Josip Juranović",720,15,9,11,3,1,12,14,NA,2,5,3,2,7,22,14,0
"1369","Josip Mišić",519,11,6,6,5,0,7,11,410,4,13,5,8,8,19,8,0
"1370","Josip Stanišić",392,9,4,5,3,1,5,8,NA,3,7,1,6,4,13,8,1
"1371","Josip Šutalo",540,12,6,11,1,0,6,8,NA,2,12,6,6,9,21,27,0
"1372","Joško Gvardiol",1306,16,11,8,8,0,8,16,NA,8,14,6,8,17,33,44,2
"1373","Josuha Guilavogui",454,8,5,0,7,1,2,10,NA,8,9,6,3,8,16,20,0
"1374","Jota",285,1,0,0,1,0,0,3,NA,3,3,0,3,3,4,0,0
"1375","Jovane Cabral",13,0,0,0,0,0,0,0,NA,0,0,0,0,0,0,0,0
"1376","Juan Bernat",864,24,15,18,4,2,17,25,NA,8,7,2,5,3,27,10,0
"1377","Juan Brandáriz",388,7,3,4,2,1,1,3,NA,2,4,1,3,6,13,17,0
"1378","Juan Cabal",57,1,1,1,0,0,1,1,NA,0,0,0,0,1,2,1,0
"1379","Juan Carlos",900,0,0,0,0,0,0,0,NA,0,0,0,0,1,1,7,1
"1380","Juan Cruz",174,1,0,0,1,0,1,3,NA,2,1,0,1,0,1,0,0
"1381","Juan Cruz Armada",1006,14,8,10,2,2,9,12,NA,3,6,4,2,6,20,24,0
"1382","Juan Cuadrado",1283,36,20,25,11,0,19,34,NA,15,14,1,13,18,54,16,0
"1383","Juan Foyth",248,6,4,3,3,0,5,7,NA,2,3,0,3,4,10,12,0
"1384","Juan Jesus",509,9,5,4,4,1,4,6,NA,2,12,6,6,6,15,19,0
"1385","Juan Larios",152,7,6,6,1,0,5,5,NA,0,2,0,2,3,10,4,0
"1386","Juan Miranda",94,4,3,3,1,0,2,2,NA,0,0,0,0,1,5,2,0
"1387","Juan Musso",727,0,0,0,0,0,0,0,NA,0,0,0,0,0,0,4,1
"1388","Juan Perea",111,2,1,0,0,2,2,2,NA,0,0,0,0,1,3,2,0
"1389","Juanjo Narváez",148,1,1,1,0,0,1,1,NA,0,2,0,2,0,1,0,0
"1390","Juanmi",313,1,0,0,0,1,1,6,100,5,2,0,2,2,3,2,0
"1391","Juanpe",615,7,4,2,5,0,4,7,NA,3,1,1,0,5,12,24,0
"1392","Jubal",1350,13,6,7,5,1,6,9,NA,3,23,17,6,28,41,78,0
"1393","Jude Bellingham",2048,63,38,24,25,14,28,40,NA,12,43,5,38,33,96,22,0
"1394","Jules Koundé",910,15,9,9,5,1,11,12,NA,1,5,3,2,9,24,9,0
"1395","Julián Álvarez",916,12,7,1,6,5,1,10,NA,9,10,0,10,2,14,5,0
"1396","Julian Baumgartlinger",263,5,2,3,1,1,1,4,NA,3,2,1,1,1,6,11,0
"1397","Julian Brandt",1438,20,13,3,11,6,7,16,NA,9,11,1,10,12,32,4,1
"1398","Julian Chabot",126,2,2,0,1,1,2,3,100,1,3,2,1,5,7,9,0
"1399","Julian Draxler",32,1,0,1,0,0,0,1,NA,1,0,0,0,0,1,0,0
"1400","Julian Jeanvier",725,10,8,9,1,0,5,8,NA,3,11,9,2,11,21,43,1
"1401","Julian Kristoffersen",18,0,0,0,0,0,0,0,NA,0,1,0,1,0,0,0,0
"1402","Julian Ryerson",1037,28,17,17,10,1,15,23,NA,8,15,3,12,12,40,19,0
"1403","Julian Weigl",903,21,7,11,9,1,11,19,NA,8,11,0,11,8,29,18,0
"1404","Julien Laporte",1350,16,11,13,3,0,12,17,NA,5,22,20,2,16,32,89,1
"1405","Julien Ponceau",770,16,11,6,8,2,7,12,NA,5,11,1,10,7,23,4,0
"1406","Julio César Enciso",80,1,0,0,1,0,0,0,NA,0,1,0,1,0,1,0,0
"1407","Julius Beck",10,2,1,1,1,0,0,0,NA,0,0,0,0,0,2,0,0
"1408","Jung Woo-young",168,3,3,2,1,0,1,2,100,1,1,0,1,1,4,3,0
"1409","Junior Dina Ebimbe",950,29,20,14,15,0,13,25,NA,12,8,3,5,8,37,14,0
"1410","Junior Firpo",114,5,4,1,4,0,2,6,75,4,2,0,2,1,6,1,0
"1411","Junior Hoilett",86,3,0,0,2,1,1,1,NA,0,0,0,0,0,3,0,0
"1412","Junior Messias",630,11,5,2,4,5,3,7,NA,4,8,2,6,5,16,8,0
"1413","Junior Sambia",54,1,0,1,0,0,1,1,NA,0,1,0,1,1,2,1,1
"1414","Junior Stanislas",61,0,0,0,0,0,0,0,NA,0,2,1,1,0,0,0,0
"1415","Junya Ito",1026,11,7,2,5,4,5,18,NA,13,8,1,7,6,17,3,0
"1416","Jurrien Timber",709,10,4,3,7,0,4,4,NA,0,9,6,3,13,23,21,1
"1417","Justin Kluivert",518,5,5,2,0,3,2,3,NA,1,1,0,1,3,8,4,0
"1418","Justin Njinmah",22,0,0,0,0,0,0,0,NA,0,0,0,0,0,0,0,0
"1419","Jutglà",470,2,1,0,2,0,0,1,NA,1,3,0,3,0,2,2,0
"1420","Kaan Ayhan",545,10,4,6,4,0,7,7,NA,0,5,4,1,5,15,26,1
"1421","Kai Havertz",1298,20,9,3,11,6,6,19,NA,13,18,0,18,1,21,16,0
"1422","Kaiky",484,5,5,5,0,0,3,6,NA,3,17,10,7,11,16,20,0
"1423","Kalidou Koulibaly",1346,33,22,25,6,2,18,26,NA,8,22,7,15,18,51,62,0
"1424","Kalvin Phillips",49,0,0,0,0,0,0,0,NA,0,0,0,0,1,1,1,0
"1425","Kamal Miller",180,4,4,4,0,0,1,1,NA,0,1,1,0,4,8,9,1
"1426","Kamal Sowah",439,7,5,4,2,1,0,2,NA,2,3,0,3,2,9,4,0
"1427","Kamaldeen Sulemana",276,6,3,1,4,1,1,4,NA,3,2,0,2,3,9,4,0
"1428","Kamil Glik",270,1,0,1,0,0,1,2,NA,1,2,1,1,2,3,21,0
"1429","Kamil Grabara",360,0,0,0,0,0,0,1,NA,1,0,0,0,0,0,1,0
"1430","Kamory Doumbia",711,15,8,4,8,3,7,20,NA,13,10,1,9,11,26,1,0
"1431","Kaoru Mitoma",377,19,11,11,4,4,9,10,NA,1,7,0,7,1,20,7,0
"1432","Karamoko Dembele",102,1,0,0,1,0,1,1,NA,0,0,0,0,0,1,0,0
"1433","Karim Adeyemi",787,7,3,3,2,2,7,18,NA,11,10,0,10,6,13,0,0
"1434","Karim Ansarifard",35,0,0,0,0,0,0,0,NA,0,1,0,1,1,1,0,0
"1435","Karim Bellarabi",49,2,0,1,1,0,2,2,200,0,0,0,0,0,2,0,0
"1436","Karim Benzema",864,4,3,2,0,2,0,1,NA,1,5,0,5,1,5,2,0
"1437","Karim Boudiaf",185,2,1,0,2,0,2,5,NA,3,0,0,0,0,2,3,0
"1438","Karim Onisiwo",1303,7,4,0,2,5,2,6,NA,4,8,0,8,1,8,2,0
"1439","Karim Rekik",513,1,0,1,0,0,1,2,NA,1,3,0,3,6,7,9,0
"1440","Karl Toko Ekambi",1165,5,5,2,1,2,2,11,NA,9,8,2,6,8,13,4,0
"1441","Karol Fila",47,0,0,0,0,0,0,0,NA,0,0,0,0,1,1,1,0
"1442","Karol Linetty",947,20,9,2,17,1,7,12,NA,5,13,3,10,13,33,15,0
"1443","Karol Świderski",45,4,1,1,1,2,2,3,66.7,1,0,0,0,2,6,0,0
"1444","Kasper Dolberg",421,2,1,0,2,0,1,4,NA,3,2,0,2,1,3,7,0
"1445","Kasper Schmeichel",1440,0,0,0,0,0,0,0,NA,0,1,0,1,1,1,1,0
"1446","Kays Ruiz",62,1,1,1,0,0,0,1,0,1,2,1,1,3,4,0,0
"1447","Keane Lewis-Potter",287,0,0,0,0,0,0,0,NA,0,5,1,4,0,0,2,0
"1448","Keanu Baccus",57,0,0,0,0,0,0,2,NA,2,0,0,0,0,0,1,0
"1449","Keidi Bare",330,7,3,4,1,2,3,7,NA,4,5,2,3,11,18,5,0
"1450","Kelechi Iheanacho",219,0,0,0,0,0,0,1,NA,1,2,1,1,0,0,1,0
"1451","Kellyn Acosta",43,3,2,3,0,0,2,2,200,0,0,0,0,0,3,0,0
"1452","Kelvin Amian",366,6,4,3,0,3,1,1,NA,0,2,0,2,3,9,12,0
"1453","Kenan Karaman",361,6,4,1,3,2,0,3,NA,3,4,0,4,1,7,3,0
"1454","Kendall Waston",135,3,1,3,0,0,1,1,NA,0,1,0,1,4,7,8,0
"1455","Kenedy",15,0,0,0,0,0,0,0,NA,0,0,0,0,0,0,0,0
"1456","Kenji-Van Boto",90,1,1,1,0,0,1,2,50,1,0,0,0,1,2,1,0
"1457","Kenneth Taylor",422,6,3,3,3,0,3,6,NA,3,4,0,4,4,10,3,0
"1458","Kenny Tete",708,29,17,18,8,3,12,13,NA,1,11,7,4,12,41,24,0
"1459","Kepa Arrizabalaga",945,2,2,2,0,0,2,3,NA,1,0,0,0,1,3,5,0
"1460","Kerem Demirbay",1051,22,11,8,13,1,9,23,NA,14,18,4,14,10,32,6,0
"1461","Kerim Calhanoglu",63,2,1,2,0,0,2,2,NA,0,1,0,1,0,2,3,0
"1462","Keven Schlotterbeck",14,0,0,0,0,0,0,0,NA,0,1,1,0,2,2,2,0
"1463","Kevin-Prince Boateng",108,2,1,1,1,0,0,1,NA,1,1,1,0,0,2,1,0
"1464","Kevin Agudelo",910,33,16,12,15,6,13,29,NA,16,21,3,18,5,38,2,0
"1465","Kevin Akpoguma",836,32,20,18,14,0,11,16,NA,5,20,5,15,10,42,23,1
"1466","Kevin Álvarez",70,1,0,1,0,0,1,1,NA,0,2,0,2,1,2,2,0
"1467","Kevin Behrens",449,3,2,2,0,1,1,3,NA,2,7,1,6,2,5,8,0
"1468","Kevin Bonifazi",416,6,4,4,2,0,3,6,NA,3,6,4,2,6,12,21,0
"1469","Kevin Danso",1350,15,9,11,3,1,7,14,NA,7,16,12,4,14,29,54,0
"1470","Kevin De Bruyne",1575,19,10,4,10,5,10,23,NA,13,16,2,14,3,22,6,0
"1471","Kevin Diks",335,13,7,7,3,3,6,7,NA,1,7,4,3,4,17,10,0
"1472","Kévin Gameiro",1065,14,6,3,10,1,5,12,NA,7,4,1,3,4,18,0,0
"1473","Kevin Jauch",2,1,0,0,1,0,0,0,NA,0,1,0,1,0,1,0,0
"1474","Kevin Kampl",904,22,15,7,13,2,6,13,NA,7,15,5,10,12,34,3,1
"1475","Kévin Keben Biakolo",304,3,2,2,0,1,0,1,NA,1,1,0,1,4,7,8,0
"1476","Kevin Lasagna",634,4,2,2,1,1,2,4,NA,2,7,1,6,1,5,4,0
"1477","Kevin Mbabu",144,3,2,2,1,0,1,3,NA,2,2,0,2,3,6,3,0
"1478","Kevin Paredes",177,3,3,1,1,1,3,4,NA,1,1,0,1,2,5,2,0
"1479","Kevin Schade",182,6,4,3,2,1,3,5,NA,2,0,0,0,0,6,2,0
"1480","Kevin Spadanuda",461,7,4,4,3,0,2,9,NA,7,4,0,4,5,12,3,0
"1481","Kevin Stöger",1203,32,15,14,14,4,11,31,NA,20,13,2,11,15,47,8,0
"1482","Kévin Théophile-Catherine",75,2,2,1,1,0,2,2,100,0,1,1,0,1,3,1,0
"1483","Kevin Trapp",1890,0,0,0,0,0,0,0,NA,0,2,0,2,0,0,4,0
"1484","Kevin Vázquez",71,2,1,0,1,1,0,0,NA,0,1,0,1,0,2,1,0
"1485","Kevin Vogt",1191,13,10,9,4,0,7,13,NA,6,10,6,4,18,31,44,0
"1486","Kevin Volland",283,4,1,0,2,2,1,3,NA,2,1,0,1,1,5,0,0
"1487","Keylor Navas",180,1,0,1,0,0,1,1,NA,0,0,0,0,1,2,0,1
"1488","Keysher Fuller",180,4,4,3,1,0,3,6,125,3,2,0,2,3,7,8,0
"1489","Khalil Fayad",329,14,7,5,9,0,5,8,NA,3,3,0,3,2,16,2,0
"1490","Khéphren Thuram-Ulie",908,19,11,8,10,1,7,15,NA,8,9,4,5,10,29,13,0
"1491","Khvicha Kvaratskhelia",1235,22,10,7,3,12,11,22,NA,11,11,0,11,0,22,8,1
"1492","Kieffer Moore",975,11,9,3,6,2,3,13,NA,10,8,5,3,2,13,19,0
"1493","Kieran Tierney",354,6,2,3,3,0,3,4,NA,1,4,1,3,6,12,12,0
"1494","Kieran Trippier",1530,35,26,20,15,0,22,37,1051.7,15,23,9,14,21,56,36,0
"1495","Kiernan Dewsbury-Hall",1134,17,10,4,12,1,7,19,NA,12,21,2,19,13,30,9,0
"1496","Kike",428,1,1,0,1,0,0,1,NA,1,0,0,0,1,2,6,0
"1497","Kike Barja",287,3,1,1,1,1,0,2,NA,2,1,0,1,2,5,1,0
"1498","Kike Pérez",966,23,7,12,9,2,7,24,NA,17,9,2,7,8,31,10,0
"1499","Kiko Femenía",847,6,3,4,1,1,4,7,NA,3,11,5,6,14,20,17,0
"1500","Kilian Fischer",114,1,0,0,1,0,0,1,NA,1,2,0,2,2,3,2,0
"1501","Kiliann Sildillia",1159,14,8,3,9,2,7,9,NA,2,12,4,8,14,28,18,1
"1502","Kim Jin-su",180,6,3,3,2,1,4,4,200,0,2,0,2,1,7,3,0
"1503","Kim Min-jae",1799,28,18,22,5,1,11,13,NA,2,24,20,4,28,56,77,1
"1504","Kim Moonhwan",180,3,2,2,1,0,2,3,150,1,2,0,2,2,5,7,0
"1505","Kim Seung-gyu",180,0,0,0,0,0,0,0,NA,0,0,0,0,2,2,1,0
"1506","Kim Young-gwon",180,1,1,1,0,0,0,1,NA,1,1,1,0,1,2,7,0
"1507","Kingsley Coman",813,13,11,3,8,2,6,10,NA,4,8,0,8,4,17,3,0
"1508","Kingsley Ehizibue",330,6,5,3,2,1,4,5,NA,1,4,1,3,3,9,6,0
"1509","Kingsley Schindler",489,13,7,8,4,1,11,16,NA,5,5,1,4,7,20,13,0
"1510","Ko Itakura",595,10,5,6,3,1,3,8,NA,5,11,6,5,10,20,36,0
"1511","Koen Casteels",1350,0,0,0,0,0,0,0,NA,0,0,0,0,1,1,5,0
"1512","Koffi Djidji",894,17,9,10,6,1,3,8,NA,5,11,4,7,18,35,27,0
"1513","Koke",1123,22,15,9,11,2,8,21,NA,13,10,5,5,2,24,9,0
"1514","Komnen Andrić",1012,10,4,2,5,3,2,11,NA,9,6,1,5,8,18,7,0
"1515","Koni De Winter",535,10,5,9,1,0,3,4,NA,1,10,10,0,6,16,28,0
"1516","Konrad Laimer",415,13,7,7,3,3,6,12,NA,6,9,1,8,4,17,2,0
"1517","Konstantinos Mavropanos",1147,29,17,20,8,1,15,17,NA,2,22,13,9,31,60,52,0
"1518","Koray Günter",810,9,5,0,8,1,3,4,NA,1,21,13,8,26,35,38,0
"1519","Kostas Stafylidis",372,15,10,6,6,3,4,6,NA,2,8,2,6,5,20,9,1
"1520","Kostas Tsimikas",708,13,8,7,6,0,8,12,NA,4,8,3,5,7,20,9,0
"1521","Kouadio Koné",1221,29,16,17,11,1,8,16,NA,8,20,5,15,11,40,4,0
"1522","Kouamé Botué",163,2,1,1,1,0,0,2,NA,2,1,0,1,0,2,1,0
"1523","Krépin Diatta",1012,5,3,1,3,1,3,6,NA,3,15,1,14,7,12,3,0
"1524","Kristian Pedersen",267,5,4,4,1,0,0,2,NA,2,3,0,3,5,10,17,0
"1525","Kristian Thorstvedt",724,6,3,3,3,0,2,7,NA,5,8,0,8,9,15,10,0
"1526","Kristijan Bistrović",428,3,1,3,0,0,0,4,NA,4,2,0,2,0,3,2,0
"1527","Kristijan Jakić",1518,41,22,23,16,2,26,45,NA,19,28,8,20,8,49,39,2
"1528","Kristjan Asllani",320,6,3,2,3,1,3,3,NA,0,2,0,2,3,9,8,0
"1529","Kristoffer Ajer",502,9,7,4,3,2,7,13,NA,6,5,4,1,5,14,11,0
"1530","Kristoffer Askildsen",501,5,2,1,2,2,2,5,NA,3,10,2,8,8,13,5,0
"1531","Krystian Bielik",196,4,2,1,2,1,2,4,NA,2,1,0,1,5,9,6,0
"1532","Krzysztof Piątek",556,2,1,0,1,1,1,4,NA,3,0,0,0,0,2,9,0
"1533","Kudus Mohammed",606,7,5,4,3,0,3,5,NA,2,7,0,7,6,13,3,0
"1534","Kurt Zouma",1184,4,2,2,2,0,3,6,NA,3,6,6,0,13,17,68,0
"1535","Kwon Chang-hoon",56,1,0,0,1,0,1,1,100,0,0,0,0,0,1,0,0
"1536","Kwon Kyung-won",1,0,0,0,0,0,0,0,NA,0,0,0,0,0,0,0,0
"1537","Kye Rowles",270,7,2,4,3,0,3,5,NA,2,8,6,2,6,13,14,1
"1538","Kyle Walker",616,2,1,1,1,0,0,4,NA,4,1,0,1,4,6,5,0
"1539","Kyle Walker-Peters",952,21,12,11,8,2,7,13,NA,6,15,5,10,10,31,22,0
"1540","Kylian Mbappé",1877,4,2,0,2,2,0,6,NA,6,3,0,3,3,7,6,0
"1541","Kyliane Dong",58,2,1,0,1,1,1,1,NA,0,0,0,0,0,2,0,0
"1542","Kyogo Furuhashi",359,2,0,1,0,1,1,1,NA,0,4,0,4,0,2,1,0
"1543","Lago Junior",52,1,0,0,1,0,1,1,NA,0,0,0,0,0,1,0,0
"1544","Lameck Banda",807,13,10,7,5,1,7,17,NA,10,14,1,13,3,16,2,0
"1545","Largie Ramazani",799,7,5,3,0,4,5,12,NA,7,6,0,6,5,12,1,0
"1546","Lars Stindl",680,7,2,2,4,1,6,10,NA,4,11,2,9,4,11,11,0
"1547","Lassana Coulibaly",991,41,21,19,17,5,16,24,NA,8,13,2,11,6,47,9,2
"1548","Lassina Franck Traoré",244,0,0,0,0,0,0,0,NA,0,0,0,0,0,0,3,0
"1549","Lassine Sinayoko",861,22,10,12,6,4,13,22,NA,9,7,0,7,7,29,13,0
"1550","Latasa",61,1,1,0,0,1,0,0,NA,0,2,1,1,1,2,1,0
"1551","Lauren Ulrich",6,1,1,0,0,1,0,0,NA,0,0,0,0,0,1,0,0
"1552","Laurent Abergel",807,32,17,23,9,0,10,27,NA,17,12,2,10,12,44,10,0
"1553","Lautaro Martínez",1718,15,8,1,9,5,3,8,NA,5,18,1,17,10,25,12,1
"1554","Lawrence Ati-Zigi",180,0,0,0,0,0,0,0,NA,0,0,0,0,0,0,0,0
"1555","Layvin Kurzawa",44,2,1,1,1,0,2,2,100,0,0,0,0,1,3,1,0
"1556","Lazar Samardzic",450,12,6,3,6,3,5,13,NA,8,2,0,2,6,18,5,0
"1557","Lázaro",206,0,0,0,0,0,0,3,NA,3,6,0,6,1,1,1,0
"1558","Leander Dendoncker",604,16,7,9,6,1,9,15,NA,6,14,4,10,15,31,13,0
"1559","Leandro Barreiro Martins",668,12,9,2,8,2,3,7,NA,4,11,4,7,10,22,7,0
"1560","Leandro Cabrera",1107,11,5,9,2,0,7,11,NA,4,15,11,4,20,31,59,2
"1561","Leandro Paredes",858,21,9,12,8,1,12,20,NA,8,12,5,7,13,34,6,0
"1562","Leandro Sanca",25,1,1,0,0,1,1,1,NA,0,0,0,0,0,1,0,0
"1563","Leandro Trossard",1219,12,7,8,2,2,3,7,NA,4,16,0,16,6,18,1,0
"1564","Lebo Mothiba",156,1,0,1,0,0,0,0,NA,0,1,0,1,0,1,1,0
"1565","Lee Buchanan",223,6,5,2,4,0,4,5,NA,1,3,0,3,7,13,10,0
"1566","Lee Jae-sung",891,19,9,3,12,4,7,17,NA,10,18,3,15,9,28,6,0
"1567","Lee Kangin",1140,15,9,3,9,3,6,24,NA,18,8,1,7,2,17,2,0
"1568","Lennart Grill",360,0,0,0,0,0,0,1,NA,1,0,0,0,0,0,0,1
"1569","Leny Yoro",101,1,1,1,0,0,0,0,NA,0,2,1,1,5,6,8,0
"1570","Léo Baptistão",564,14,9,7,5,2,8,13,NA,5,3,0,3,8,22,4,0
"1571","Leo Greiml",222,3,1,1,1,1,3,5,NA,2,4,3,1,1,4,10,0
"1572","Léo Leroy",256,14,10,7,5,2,9,16,NA,7,7,1,6,2,16,1,0
"1573","Leo Skiri Østigård",310,5,2,3,2,0,2,3,NA,1,4,1,3,3,8,22,0
"1574","Leon Bailey",827,6,3,3,2,1,3,10,NA,7,6,0,6,2,8,3,0
"1575","Leon Goretzka",1061,31,24,14,15,2,15,25,NA,10,14,2,12,8,39,13,1
"1576","Leon King",374,10,5,8,1,1,3,11,NA,8,5,2,3,5,15,12,0
"1577","Leonardo Balerdi",1691,41,25,25,14,2,21,35,NA,14,28,18,10,45,86,54,1
"1578","Leonardo Bittencourt",572,15,9,2,11,2,5,10,NA,5,3,0,3,7,22,1,0
"1579","Leonardo Bonucci",954,5,3,2,3,0,3,7,NA,4,13,11,2,9,14,32,0
"1580","Leonardo César Jardim",450,NA,0,NA,NA,NA,NA,NA,NA,NA,NA,NA,NA,0,NA,NA,NA
"1581","Leonardo Sernicola",815,20,15,10,6,4,11,13,NA,2,8,1,7,18,38,16,0
"1582","Leonardo Spinazzola",737,4,3,3,1,0,2,3,NA,1,10,3,7,4,8,12,0
"1583","Leroy Sané",1148,14,11,1,8,5,5,11,NA,6,6,1,5,4,18,0,0
"1584","Levi Colwill",103,1,1,0,1,0,0,0,NA,0,2,1,1,5,6,3,0
"1585","Levin Öztunalı",6,0,0,0,0,0,0,1,0,1,0,0,0,0,0,0,0
"1586","Lewis Cook",1193,25,16,8,14,3,10,23,558.3,13,20,8,12,14,39,16,0
"1587","Lewis Dunk",1260,10,6,9,1,0,4,11,NA,7,15,10,5,16,26,45,0
"1588","Lewis Ferguson",363,10,4,5,2,3,3,6,NA,3,3,2,1,5,15,7,0
"1589","Lewis Hall",72,1,0,1,0,0,1,3,33.3,2,0,0,0,3,4,1,0
"1590","Lewis O'Brien",525,16,9,4,11,1,6,10,NA,4,12,2,10,5,21,7,0
"1591","Liam Cooper",675,13,8,10,3,0,7,13,NA,6,4,2,2,16,29,31,1
"1592","Liam Henderson",580,6,5,4,1,1,2,12,NA,10,6,1,5,7,13,2,0
"1593","Liam Millar",10,0,0,0,0,0,0,0,NA,0,0,0,0,0,0,0,0
"1594","Liberato Cacace",130,11,5,7,3,1,5,6,175,1,5,3,2,0,11,2,0
"1595","Libor Holík",290,5,1,3,2,0,4,8,NA,4,2,0,2,4,9,10,0
"1596","Liel Abada",217,1,1,0,0,1,0,2,NA,2,0,0,0,2,3,1,0
"1597","Lilian Brassier",1200,14,7,9,4,1,6,10,NA,4,12,4,8,26,40,43,0
"1598","Lilian Egloff",236,11,9,3,5,3,4,5,NA,1,1,0,1,1,12,1,0
"1599","Linton Maina",808,9,5,1,7,1,5,8,NA,3,5,0,5,1,10,3,0
"1600","Lionel Messi",1830,15,12,0,6,9,4,12,NA,8,8,0,8,2,17,0,0
"1601","Lisandro Martínez",1326,28,13,20,7,1,19,24,NA,5,28,14,14,20,48,68,0
"1602","Lloyd Kelly",450,6,5,4,2,0,4,6,NA,2,5,5,0,6,12,24,0
"1603","Logan Costa",45,0,0,0,0,0,0,0,NA,0,0,0,0,1,1,0,0
"1604","Lohann Doucet",64,2,0,2,0,0,2,3,NA,1,2,0,2,1,3,0,0
"1605","Loïc Bade",90,1,1,1,0,0,0,0,NA,0,0,0,0,1,2,3,0
"1606","Lois Diony",437,1,0,0,1,0,1,3,NA,2,2,0,2,0,1,1,0
"1607","Loïs Openda",958,3,2,1,1,1,1,7,NA,6,5,0,5,1,4,0,0
"1608","Loren Morón",15,2,2,0,1,1,0,0,NA,0,0,0,0,0,2,1,0
"1609","Lorenz Assignon",179,6,2,4,2,0,2,4,NA,2,4,0,4,2,8,2,0
"1610","Lorenzo Colombo",400,7,2,0,5,2,2,5,NA,3,3,0,3,0,7,1,0
"1611","Lorenzo De Silvestri",518,2,2,1,0,1,2,5,NA,3,5,5,0,2,4,16,0
"1612","Lorenzo Montipò",1080,0,0,0,0,0,0,0,NA,0,0,0,0,0,0,13,2
"1613","Lorenzo Pellegrini",957,23,10,8,12,3,6,15,NA,9,8,1,7,9,32,8,0
"1614","Lorenzo Pirola",360,12,9,9,3,0,8,9,450,1,9,7,2,7,19,15,0
"1615","Lorenzo Venuti",351,9,2,3,5,1,5,9,NA,4,1,1,0,3,12,12,2
"1616","Lovro Majer",583,11,4,5,3,3,2,9,NA,7,3,0,3,9,20,2,1
"1617","Luca Caldirola",714,8,3,6,1,1,3,7,NA,4,8,4,4,9,17,22,0
"1618","Luca D'Andrea",245,2,0,1,1,0,1,2,NA,1,1,0,1,1,3,0,0
"1619","Luca de la Torre",54,3,2,2,0,1,0,1,NA,1,1,1,0,0,3,0,0
"1620","Luca Kilian",1096,22,16,14,7,1,12,21,NA,9,16,8,8,10,32,48,0
"1621","Luca Koleosho",25,0,0,0,0,0,0,1,NA,1,1,0,1,0,0,0,0
"1622","Luca Marrone",135,0,0,0,0,0,0,2,NA,2,2,2,0,0,0,4,1
"1623","Luca Netz",143,8,4,6,2,0,6,7,NA,1,0,0,0,1,9,12,0
"1624","Luca Pellegrini",758,20,11,11,8,1,12,15,NA,3,12,2,10,10,30,16,1
"1625","Luca Pfeiffer",407,1,1,1,0,0,0,1,NA,1,1,0,1,1,2,3,0
"1626","Luca Ranieri",90,0,0,0,0,0,0,1,0,1,0,0,0,3,3,4,0
"1627","Luca Waldschmidt",277,4,1,1,1,2,1,4,NA,3,1,0,1,2,6,3,0
"1628","Luca Zanimacchia",634,17,10,8,6,3,8,20,NA,12,7,0,7,9,26,4,0
"1629","Lucas Alario",259,3,2,1,0,2,0,0,NA,0,0,0,0,0,3,10,0
"1630","Lucas Boyé",730,10,5,2,6,2,7,10,NA,3,11,2,9,6,16,13,0
"1631","Lucas Cavallini",19,0,0,0,0,0,0,0,NA,0,0,0,0,0,0,0,0
"1632","Lucas Chevalier",810,1,1,1,0,0,1,1,NA,0,0,0,0,1,2,1,2
"1633","Lucas Digne",811,20,7,13,7,0,15,21,NA,6,10,5,5,12,32,23,0
"1634","Lucas Gourna-Douath",315,12,6,2,10,0,5,9,NA,4,3,0,3,4,16,1,0
"1635","Lucas Hernández",661,10,7,6,4,0,8,11,NA,3,5,3,2,13,23,9,0
"1636","Lucas Höler",101,1,1,0,1,0,0,0,NA,0,2,0,2,0,1,2,0
"1637","Lucas Martínez Quarta",1001,43,23,25,16,2,27,36,NA,9,18,8,10,24,67,41,1
"1638","Lucas Moura",273,10,7,2,3,5,2,3,NA,1,2,0,2,2,12,1,0
"1639","Lucas Ocampos",149,3,1,0,2,1,1,3,NA,2,1,0,1,2,5,2,1
"1640","Lucas Olaza",641,13,9,8,4,1,9,11,NA,2,10,2,8,7,20,14,0
"1641","Lucas Oliveira Rosa",323,16,6,11,3,2,6,9,NA,3,6,1,5,7,23,7,0
"1642","Lucas Paquetá",865,27,21,11,14,2,5,13,NA,8,16,3,13,6,33,17,0
"1643","Lucas Pérez",593,3,2,2,1,0,1,3,NA,2,2,0,2,1,4,3,0
"1644","Lucas Perrin",553,10,7,5,4,1,5,14,NA,9,3,2,1,11,21,19,0
"1645","Lucas Robertone",1016,15,8,6,7,2,6,19,NA,13,22,3,19,16,31,14,0
"1646","Lucas Taylor",312,7,2,5,2,0,2,6,NA,4,4,1,3,3,10,15,0
"1647","Lucas Torró",1122,20,13,7,10,3,7,11,NA,4,7,1,6,13,33,23,0
"1648","Lucas Tousart",1245,34,19,15,15,4,11,23,NA,12,14,1,13,19,53,34,0
"1649","Lucas Vázquez",554,15,8,5,9,1,5,8,NA,3,5,0,5,7,22,7,0
"1650","Lucas Veríssimo",3,0,0,0,0,0,0,0,NA,0,0,0,0,0,0,0,0
"1651","Lucien Agoume",106,4,2,1,2,1,2,3,NA,1,2,1,1,2,6,1,0
"1652","Luděk Pernica",495,6,4,5,1,0,5,10,NA,5,6,4,2,3,9,20,0
"1653","Ludovic Ajorque",508,1,1,0,1,0,1,5,NA,4,1,1,0,1,2,4,0
"1654","Ludovic Blas",1048,20,14,7,9,4,4,18,NA,14,7,0,7,9,29,4,0
"1655","Ludwig Augustinsson",53,1,1,1,0,0,0,0,NA,0,0,0,0,0,1,1,0
"1656","Luigi Sepe",1170,0,0,0,0,0,0,1,NA,1,0,0,0,0,0,0,0
"1657","Luis Alberto",412,2,1,0,1,1,0,7,NA,7,5,1,4,2,4,1,0
"1658","Luis Chávez",270,1,0,0,1,0,1,4,100,3,6,0,6,1,2,3,0
"1659","Luis Díaz",882,14,10,4,7,3,5,9,NA,4,9,1,8,2,16,0,0
"1660","Luis Hernández",1079,8,5,5,2,1,6,9,NA,3,13,12,1,11,19,54,0
"1661","Luis Javier Suárez",407,5,1,1,3,1,2,4,NA,2,3,0,3,3,8,7,0
"1662","Luís Maximiano",5,0,0,0,0,0,0,0,NA,0,0,0,0,0,0,0,0
"1663","Luis Milla",650,19,12,11,6,2,11,18,466.7,7,3,0,3,9,28,8,1
"1664","Luis Muriel",518,4,3,1,1,2,1,6,NA,5,4,0,4,0,4,2,0
"1665","Luís Neto",39,1,1,0,1,0,0,0,NA,0,1,1,0,0,1,2,0
"1666","Luis Pérez",387,15,8,8,4,3,8,11,426.7,3,5,3,2,5,20,7,0
"1667","Luis Sinisterra",453,11,8,2,7,2,6,10,NA,4,4,0,4,6,17,1,0
"1668","Luis Suárez",81,0,0,0,0,0,0,1,NA,1,0,0,0,0,0,0,0
"1669","Luiz Felipe",414,9,6,4,5,0,4,7,NA,3,12,6,6,3,12,18,0
"1670","Luiz Henrique",741,22,16,10,9,3,7,20,NA,13,8,0,8,6,28,4,0
"1671","Luka Ivanušec",524,7,2,1,6,0,3,7,NA,4,3,1,2,6,13,1,0
"1672","Luka Jović",704,5,2,1,3,1,2,4,NA,2,3,1,2,2,7,8,0
"1673","Luka Lochoshvili",874,22,6,16,3,3,13,18,830,5,17,3,14,14,36,30,0
"1674","Luka Milivojević",279,9,5,4,3,2,6,6,NA,0,8,1,7,6,15,8,0
"1675","Luka Modrić",1359,18,8,6,8,4,9,15,NA,6,11,4,7,13,31,4,0
"1676","Luka Romero",68,0,0,0,0,0,0,1,0,1,2,0,2,1,1,0,0
"1677","Luka Sučić",398,5,3,1,1,3,3,10,NA,7,9,1,8,4,9,3,0
"1678","Lukáš Hejda",512,8,3,7,0,1,1,2,NA,1,9,7,2,7,15,22,0
"1679","Lukáš Hrádecký",1799,0,0,0,0,0,0,0,NA,0,0,0,0,0,0,2,2
"1680","Lukáš Kalvach",492,13,5,6,5,2,4,16,NA,12,9,0,9,14,27,5,0
"1681","Lukas Klostermann",111,2,1,0,2,0,1,1,NA,0,0,0,0,0,2,2,0
"1682","Lukas Kübler",422,8,4,3,1,4,4,6,NA,2,4,2,2,4,12,6,0
"1683","Lukas Lerager",450,8,4,4,3,1,3,9,NA,6,6,0,6,14,22,5,0
"1684","Lukas Nmecha",817,5,3,0,2,3,3,3,NA,0,4,0,4,3,8,3,0
"1685","Lukas Petkov",146,5,1,4,1,0,2,3,NA,1,4,1,3,1,6,0,0
"1686","Łukasz Fabiański",1243,0,0,0,0,0,0,0,NA,0,0,0,0,0,0,3,0
"1687","Łukasz Poręba",202,3,2,1,1,1,2,2,NA,0,2,0,2,2,5,2,0
"1688","Łukasz Skorupski",1170,1,1,1,0,0,1,1,NA,0,0,0,0,0,1,7,1
"1689","Luke Ayling",159,6,2,6,0,0,1,5,NA,4,4,3,1,2,8,3,0
"1690","Luke Harris",7,0,0,0,0,0,0,0,NA,0,0,0,0,0,0,0,0
"1691","Luke Shaw",1027,18,10,8,8,2,10,14,NA,4,16,1,15,15,33,14,0
"1692","Luke Thomas",273,5,4,2,2,1,3,6,NA,3,5,0,5,5,10,10,0
"1693","Lyanco",236,5,2,2,3,0,4,6,NA,2,7,6,1,3,8,11,1
"1694","Lynnt Audoor",11,1,0,0,0,1,0,0,NA,0,0,0,0,0,1,0,0
"1695","M'Bala Nzola",1260,6,3,0,3,3,1,5,NA,4,12,4,8,3,9,14,0
"1696","M'Baye Niang",555,3,2,0,2,1,0,2,NA,2,4,1,3,0,3,7,0
"1697","Mads Bech Sørensen",20,0,0,0,0,0,0,0,NA,0,0,0,0,1,1,1,0
"1698","Mads Pedersen",694,17,9,11,5,1,5,8,NA,3,16,4,12,11,28,21,0
"1699","Mads Roerslev",433,6,3,6,0,0,2,6,NA,4,9,4,5,2,8,12,0
"1700","Maghnes Akliouche",248,6,3,3,3,0,1,3,NA,2,1,0,1,2,8,2,0
"1701","Mahdi Camara",582,18,9,1,16,1,5,12,NA,7,17,1,16,11,29,3,0
"1702","Mahir Madatov",21,0,0,0,0,0,0,0,NA,0,0,0,0,0,0,1,0
"1703","Mahmoud Dahoud",182,8,6,2,3,3,6,6,300,0,4,1,3,4,12,2,0
"1704","Majid Hosseini",270,7,4,6,1,0,6,8,250,2,3,2,1,6,13,11,0
"1705","Makoto Hasebe",464,7,6,6,1,0,3,6,NA,3,7,2,5,5,12,26,0
"1706","Malang Sarr",243,3,2,3,0,0,0,2,NA,2,4,2,2,9,12,12,0
"1707","Malcolm Ebiowei",34,1,1,1,0,0,0,1,NA,1,2,0,2,0,1,0,0
"1708","Malcom Abdulai Ares Djalo",5,0,0,0,0,0,0,0,NA,0,0,0,0,0,0,0,0
"1709","Malick Thiaw",392,5,3,4,1,0,1,2,NA,1,6,5,1,10,15,32,1
"1710","Malik Tillman",244,10,5,3,4,3,6,9,350,3,2,0,2,3,13,4,0
"1711","Malo Gusto",1214,30,20,15,8,7,13,27,NA,14,19,2,17,21,51,19,1
"1712","Mama Samba Baldé",1206,22,8,6,9,7,8,10,NA,2,12,1,11,4,26,4,0
"1713","Mamadou Mbaye",209,1,0,0,1,0,1,1,NA,0,2,1,1,1,2,14,0
"1714","Mamadou Sakho",392,6,3,2,4,0,2,3,NA,1,7,5,2,5,11,13,0
"1715","Mamady Diarra",66,2,1,2,0,0,1,2,NA,1,2,0,2,0,2,0,0
"1716","Mamoudou Karamoko",45,0,0,0,0,0,0,0,NA,0,0,0,0,0,0,1,0
"1717","Manolo Gabbiadini",528,2,0,0,0,2,0,3,NA,3,2,0,2,1,3,2,0
"1718","Manor Solomon",25,1,0,1,0,0,1,1,100,0,0,0,0,0,1,0,0
"1719","Manu Morlanes",145,3,2,2,1,0,3,3,NA,0,2,1,1,1,4,2,0
"1720","Manu Trigueros",250,4,2,2,2,0,2,7,NA,5,2,1,1,1,5,2,0
"1721","Manu Vallejo",206,4,1,1,2,1,1,6,NA,5,2,0,2,1,5,3,0
"1722","Manuel Akanji",1196,26,15,11,12,3,18,23,NA,5,14,3,11,9,35,20,0
"1723","Manuel De Luca",33,0,0,0,0,0,0,0,NA,0,0,0,0,0,0,0,0
"1724","Manuel Gulde",80,1,0,1,0,0,0,0,NA,0,0,0,0,2,3,6,0
"1725","Manuel Lanzini",126,0,0,0,0,0,0,2,NA,2,1,0,1,0,0,0,0
"1726","Manuel Lazzari",808,18,13,8,7,3,13,22,NA,9,12,3,9,11,29,14,1
"1727","Manuel Locatelli",1039,31,18,10,15,6,16,22,NA,6,22,8,14,14,45,15,0
"1728","Manuel Neuer",1530,0,0,0,0,0,0,0,NA,0,0,0,0,0,0,4,2
"1729","Manuel Riemann",1350,0,0,0,0,0,0,0,NA,0,0,0,0,1,1,11,3
"1730","Manuel Sánchez",470,15,11,11,4,0,10,14,NA,4,10,1,9,5,20,11,0
"1731","Manuel Ugarte Ribeiro",467,29,17,10,18,1,7,14,333.3,7,8,0,8,13,42,8,1
"1732","Maranhão",370,4,1,1,1,2,1,2,NA,1,2,0,2,0,4,0,0
"1733","Marash Kumbulla",44,0,0,0,0,0,0,0,NA,0,0,0,0,0,0,2,0
"1734","Marc-André ter Stegen",1710,0,0,0,0,0,0,0,NA,0,0,0,0,1,1,3,2
"1735","Marc-Oliver Kempf",1294,25,15,17,7,1,12,15,NA,3,26,20,6,27,52,59,0
"1736","Marc Albrighton",31,2,0,0,1,1,1,2,NA,1,3,1,2,0,2,2,0
"1737","Marc Casado",24,0,0,0,0,0,0,0,NA,0,2,1,1,0,0,1,0
"1738","Marc Cucurella",1049,32,18,18,8,6,16,24,NA,8,21,4,17,10,42,25,0
"1739","Marc Guéhi",1260,16,5,13,3,0,9,16,NA,7,21,12,9,18,34,47,0
"1740","Marc Roca",1031,31,19,13,17,1,8,24,NA,16,12,6,6,14,45,9,0
"1741","Marcão",583,9,7,4,5,0,6,7,NA,1,10,5,5,6,15,22,0
"1742","Marcel Halstenberg",755,19,11,12,7,0,9,17,NA,8,10,1,9,8,27,14,0
"1743","Marcel Sabitzer",907,36,21,17,12,7,15,24,NA,9,7,1,6,15,51,12,0
"1744","Marcel Wenig",4,0,0,0,0,0,0,0,NA,0,0,0,0,0,0,0,0
"1745","Marcelo Brozović",964,21,12,11,8,2,4,15,NA,11,21,8,13,13,34,11,0
"1746","Marcin Bułka",180,0,0,0,0,0,0,1,NA,1,0,0,0,1,1,0,0
"1747","Marcin Kamiński",90,0,0,0,0,0,0,0,NA,0,2,2,0,3,3,5,0
"1748","Marcin Listkowski",77,0,0,0,0,0,0,0,NA,0,0,0,0,3,3,2,0
"1749","Marco Asensio",571,7,4,3,3,1,3,6,NA,3,5,0,5,4,11,3,0
"1750","Marco Benassi",93,3,3,2,0,1,3,4,NA,1,0,0,0,1,4,1,0
"1751","Marco Bizot",1260,0,0,0,0,0,0,0,NA,0,1,0,1,0,0,10,1
"1752","Marco Carnesecchi",450,0,0,0,0,0,0,0,NA,0,0,0,0,0,0,2,0
"1753","Marco D'Alessandro",199,2,2,1,1,0,1,2,NA,1,0,0,0,1,3,2,0
"1754","Marco Friedl",1154,23,14,15,8,0,13,22,NA,9,21,7,14,35,58,46,1
"1755","Marco Pašalić",11,0,0,0,0,0,0,0,NA,0,0,0,0,0,0,0,0
"1756","Marco Reus",811,19,12,7,9,3,2,11,NA,9,8,1,7,3,22,4,0
"1757","Marco Richter",527,9,4,5,3,1,7,14,NA,7,8,0,8,7,16,5,0
"1758","Marco Silvestri",1260,1,0,1,0,0,1,1,NA,0,0,0,0,1,2,3,0
"1759","Marco Sportiello",533,1,0,1,0,0,1,2,NA,1,0,0,0,0,1,1,0
"1760","Marco Verratti",1494,66,39,30,31,5,32,59,NA,27,36,10,26,19,85,3,2
"1761","Marcos Acuña",938,32,18,21,10,1,20,26,NA,6,11,3,8,14,46,16,0
"1762","Marcos Alonso",853,11,6,6,4,1,7,11,NA,4,12,9,3,12,23,28,0
"1763","Marcos Antônio",208,2,1,2,0,0,2,4,NA,2,2,0,2,2,4,8,0
"1764","Marcos Llorente",874,16,8,9,5,2,10,13,NA,3,9,0,9,10,26,13,0
"1765","Marcos Senesi",939,22,13,14,8,0,8,13,NA,5,16,10,6,16,38,57,0
"1766","Marcus Coco",161,5,4,3,0,2,1,5,NA,4,4,2,2,3,8,1,0
"1767","Marcus Edwards",352,3,0,3,0,0,1,6,NA,5,1,0,1,1,4,1,0
"1768","Marcus Ingvartsen",457,1,0,0,0,1,1,4,NA,3,5,1,4,1,2,3,0
"1769","Marcus Rashford",1234,8,2,3,3,2,2,9,NA,7,14,2,12,3,11,4,0
"1770","Marcus Tavernier",1283,25,16,14,10,1,7,14,NA,7,15,1,14,4,29,20,0
"1771","Marcus Thuram",1379,8,3,1,3,4,4,6,NA,2,8,2,6,5,13,11,0
"1772","Marek Rodák",180,0,0,0,0,0,0,0,NA,0,0,0,0,0,0,1,1
"1773","Marián Tvrdoň",90,0,0,0,0,0,0,0,NA,0,0,0,0,0,0,0,0
"1774","Mariano",30,1,0,0,1,0,0,0,NA,0,0,0,0,0,1,0,0
"1775","Marin Jakoliš",28,1,1,0,0,1,0,0,NA,0,0,0,0,0,1,0,0
"1776","Marin Pongračić",790,16,14,8,7,1,5,6,NA,1,4,3,1,16,32,31,0
"1777","Mario Gila",90,3,1,3,0,0,0,1,NA,1,0,0,0,3,6,3,0
"1778","Mario Götze",1613,27,13,8,13,6,10,32,NA,22,18,1,17,10,37,6,0
"1779","Mario Hermoso",278,1,1,0,0,1,1,3,NA,2,4,3,1,5,6,15,0
"1780","Mario Lemina",721,30,20,10,13,7,11,17,NA,6,13,5,8,9,39,16,0
"1781","Mario Pašalić",853,14,5,2,11,1,4,11,NA,7,9,1,8,13,27,6,0
"1782","Mário Rui",1062,18,12,12,4,2,10,16,NA,6,9,4,5,14,32,21,1
"1783","Mario Suárez",6,0,0,0,0,0,0,0,NA,0,1,0,1,0,0,0,0
"1784","Marius Bülter",1173,8,4,5,1,2,6,12,NA,6,14,0,14,7,15,7,0
"1785","Marius Wolf",530,8,5,3,3,2,5,7,NA,2,14,3,11,8,16,9,0
"1786","Mark Flekken",1350,0,0,0,0,0,0,1,NA,1,0,0,0,0,0,3,3
"1787","Mark Travers",675,0,0,0,0,0,0,0,NA,0,1,0,1,0,0,4,0
"1788","Mark Uth",46,0,0,0,0,0,0,0,NA,0,0,0,0,0,0,0,0
"1789","Marko Arnautović",1009,7,4,2,3,2,0,3,NA,3,7,1,6,2,9,8,0
"1790","Marko Bulat",29,2,1,2,0,0,1,1,NA,0,0,0,0,0,2,2,0
"1791","Marko Dmitrović",405,0,0,0,0,0,0,0,NA,0,1,0,1,0,0,2,0
"1792","Marko Grujić",111,3,3,3,0,0,1,2,NA,1,1,0,1,0,3,5,0
"1793","Marko Lazetić",9,0,0,0,0,0,0,0,NA,0,0,0,0,0,0,0,0
"1794","Marko Livaja",79,1,1,0,0,1,0,2,NA,2,0,0,0,0,1,1,0
"1795","Marko Milovanović",15,0,0,0,0,0,0,0,NA,0,0,0,0,0,0,0,0
"1796","Marko Pjaca",348,2,1,1,1,0,2,4,NA,2,1,0,1,0,2,0,0
"1797","Marko Stamenic",269,3,1,1,1,1,1,6,33.3,5,8,2,6,3,6,2,0
"1798","Marlon",639,8,4,3,5,0,5,9,NA,4,3,1,2,8,16,17,0
"1799","Marlos Moreno",4,0,0,0,0,0,0,0,NA,0,1,1,0,0,0,0,0
"1800","Marquinhos",1813,21,15,13,7,1,15,20,NA,5,23,13,10,18,39,52,1
"1801","Marshall Munetsi",904,24,9,5,16,3,9,17,NA,8,12,2,10,15,39,15,0
"1802","Marten de Roon",1113,27,17,13,13,1,13,28,NA,15,10,2,8,16,43,24,0
"1803","Martin Adeline",93,3,3,2,1,0,3,4,NA,1,3,1,2,2,5,2,0
"1804","Martin Baturina",60,3,1,2,0,1,2,2,NA,0,1,0,1,0,3,0,0
"1805","Martin Braithwaite",802,5,0,1,2,2,2,4,NA,2,4,0,4,1,6,5,0
"1806","Martín Cáceres",90,0,0,0,0,0,0,2,0,2,0,0,0,0,0,2,0
"1807","Martin Erlic",777,5,4,3,2,0,1,4,NA,3,16,10,6,13,18,31,0
"1808","Martin Hongla",379,3,2,1,2,0,2,2,NA,0,7,2,5,6,9,9,0
"1809","Martín Montoya",183,7,5,5,2,0,6,6,300,0,2,0,2,2,9,5,0
"1810","Martin Ødegaard",1074,12,7,6,4,2,2,10,NA,8,6,1,5,2,14,5,0
"1811","Martin Satriano",735,5,2,2,2,1,1,3,NA,2,4,0,4,1,6,8,0
"1812","Martin Terrier",1196,23,10,7,8,8,12,23,NA,11,14,2,12,13,36,6,0
"1813","Martin Valjent",1155,14,9,11,3,0,8,11,NA,3,23,10,13,17,31,51,0
"1814","Martín Zubimendi",1151,23,13,11,11,1,7,13,NA,6,16,8,8,13,36,26,3
"1815","Martinelli",1185,12,7,5,2,5,1,6,NA,5,13,1,12,7,19,9,0
"1816","Márton Dárdai",181,2,1,2,0,0,0,1,NA,1,1,1,0,5,7,13,0
"1817","Marvin Ducksch",1302,5,2,1,3,1,2,9,NA,7,5,0,5,5,10,20,0
"1818","Marvin Friedrich",963,13,9,10,2,1,8,10,NA,2,9,4,5,11,24,39,0
"1819","Marvin Plattenhardt",996,23,16,15,7,1,17,27,NA,10,11,4,7,7,30,27,0
"1820","Marvin Schwäbe",1350,0,0,0,0,0,0,0,NA,0,0,0,0,2,2,4,1
"1821","Marvin Senaya",9,0,0,0,0,0,0,1,0,1,1,0,1,0,0,1,0
"1822","Maryan Shved",187,6,2,4,2,0,3,7,150,4,4,0,4,4,10,2,0
"1823","Mason Holgate",320,8,4,7,1,0,3,5,NA,2,5,2,3,6,14,22,0
"1824","Mason Mount",1581,38,20,8,19,11,15,28,NA,13,22,5,17,5,43,7,0
"1825","Massadio Haïdara",743,15,10,8,4,3,8,13,NA,5,16,6,10,24,39,13,0
"1826","Mateo Fernández",2,0,0,0,0,0,0,0,NA,0,0,0,0,0,0,1,0
"1827","Mateo Kovačić",1157,25,17,7,14,4,9,19,NA,10,9,1,8,15,40,8,0
"1828","Mateus Fernandes",30,1,0,1,0,0,1,1,100,0,2,1,1,0,1,2,0
"1829","Mateus Uribe",436,7,7,2,5,0,2,11,120,9,5,2,3,6,13,6,0
"1830","Mateusz Klich",199,11,7,2,4,5,6,10,NA,4,1,0,1,0,11,1,0
"1831","Mateusz Lis",270,0,0,0,0,0,0,0,NA,0,1,0,1,0,0,0,0
"1832","Mateusz Wieteska",1350,17,12,11,6,0,10,14,NA,4,15,8,7,23,40,44,1
"1833","Matheus Cunha",499,6,2,1,3,2,1,4,NA,3,8,1,7,3,9,3,0
"1834","Matheus Henrique",486,7,5,2,5,0,1,2,NA,1,3,0,3,5,12,3,0
"1835","Matheus Nunes",866,22,14,10,7,5,6,13,NA,7,11,0,11,3,25,12,0
"1836","Matheus Reis",509,10,7,5,5,0,6,7,NA,1,4,2,2,3,13,17,0
"1837","Mathew Leckie",262,4,4,1,3,0,2,5,150,3,3,0,3,0,4,6,0
"1838","Mathew Ryan",450,0,0,0,0,0,0,0,NA,0,0,0,0,0,0,5,0
"1839","Mathias Autret",860,14,8,6,7,1,3,8,NA,5,9,2,7,6,20,8,0
"1840","Mathias Jensen",1211,37,18,12,17,8,14,34,NA,20,19,0,19,15,52,9,1
"1841","Mathias Jørgensen",457,8,3,7,1,0,4,8,NA,4,13,9,4,9,17,17,1
"1842","Mathias Olesen",97,3,0,1,1,1,2,2,NA,0,1,0,1,1,4,1,0
"1843","Mathías Olivera",811,29,21,14,11,4,14,19,NA,5,16,0,16,9,38,26,0
"1844","Mathias Pereira Lage",942,12,5,4,8,0,7,22,NA,15,5,1,4,13,25,11,0
"1845","Mathieu Coutadeur",802,11,7,5,6,0,4,8,NA,4,7,0,7,10,21,9,0
"1846","Mathys Tel",293,1,1,1,0,0,1,1,NA,0,8,1,7,2,3,0,0
"1847","Matìas Soulé",164,1,1,1,0,0,1,3,NA,2,1,0,1,1,2,1,0
"1848","Matías Vecino",713,15,8,7,5,3,9,12,NA,3,10,2,8,10,25,8,0
"1849","Matías Viña",72,8,4,5,2,1,4,5,NA,1,5,1,4,2,10,5,0
"1850","Matija Nastasić",285,4,3,2,1,1,0,2,NA,2,1,0,1,8,12,19,0
"1851","Matis Carvalho",136,0,0,0,0,0,0,0,NA,0,0,0,0,1,1,0,0
"1852","Mato Jajalo",51,0,0,0,0,0,0,1,NA,1,0,0,0,0,0,2,0
"1853","Mats Hummels",1373,36,18,17,19,0,18,35,NA,17,25,15,10,28,64,60,0
"1854","Matt Doherty",427,9,4,6,2,1,6,6,NA,0,7,4,3,8,17,7,1
"1855","Matt O'Riley",481,18,7,4,10,4,4,13,NA,9,9,2,7,11,29,4,0
"1856","Matt Ritchie",1,0,0,0,0,0,0,0,NA,0,0,0,0,0,0,0,0
"1857","Matt Targett",426,11,8,6,3,2,8,15,NA,7,4,1,3,7,18,12,0
"1858","Matt Turner",270,0,0,0,0,0,0,0,NA,0,0,0,0,0,0,1,0
"1859","Matteo Bianchetti",908,16,9,11,4,1,11,16,NA,5,18,12,6,6,22,54,0
"1860","Matteo Cancellieri",119,4,1,3,0,1,3,4,NA,1,3,0,3,1,5,1,0
"1861","Matteo Darmian",699,25,17,13,7,5,10,15,NA,5,8,2,6,6,31,18,0
"1862","Matteo Gabbia",430,6,3,5,1,0,5,5,NA,0,4,1,3,5,11,22,0
"1863","Mattéo Guendouzi",1548,23,12,5,15,3,10,25,NA,15,8,5,3,17,40,9,0
"1864","Matteo Lovato",90,4,3,4,0,0,4,5,80,1,0,0,0,0,4,4,0
"1865","Matteo Pessina",739,6,3,2,3,1,3,9,NA,6,15,0,15,11,17,6,0
"1866","Matteo Politano",804,20,10,8,8,4,10,13,NA,3,3,0,3,5,25,9,0
"1867","Matteo Ruggeri",115,1,0,1,0,0,1,1,NA,0,4,2,2,5,6,4,0
"1868","Matthias Ginter",1350,18,10,10,7,1,12,21,NA,9,19,10,9,20,38,54,1
"1869","Matthijs de Ligt",1111,12,8,7,5,0,4,5,NA,1,13,9,4,13,25,48,0
"1870","Matthis Abline",105,1,1,0,0,1,1,1,NA,0,1,0,1,2,3,1,0
"1871","Mattia Caldara",509,10,6,6,2,2,6,11,NA,5,5,3,2,7,17,31,1
"1872","Mattia De Sciglio",555,8,6,2,4,2,7,9,NA,2,5,2,3,3,11,9,0
"1873","Mattia Destro",450,1,1,0,1,0,0,0,NA,0,2,0,2,1,2,4,0
"1874","Mattia Perin",678,0,0,0,0,0,0,0,NA,0,0,0,0,0,0,0,0
"1875","Mattia Valoti",209,7,3,2,4,1,4,7,NA,3,4,1,3,2,9,3,0
"1876","Mattia Viti",601,4,2,1,1,2,2,5,NA,3,9,3,6,8,12,18,0
"1877","Mattia Zaccagni",846,10,7,3,5,2,3,5,NA,2,12,2,10,5,15,3,0
"1878","Mattias Svanberg",627,10,6,5,5,0,3,9,NA,6,8,3,5,8,18,12,0
"1879","Matty Cash",1298,27,15,17,6,4,13,19,NA,6,14,4,10,18,45,33,0
"1880","Matz Sels",1350,2,1,2,0,0,2,2,NA,0,0,0,0,1,3,13,0
"1881","Maurits Kjærgaard",495,21,11,6,10,5,9,18,342.9,9,10,2,8,4,25,2,0
"1882","Mauro Arambarri",511,7,4,3,3,1,1,11,20,10,10,3,7,5,12,7,0
"1883","Mavis Tchibota",93,2,2,0,1,1,1,5,NA,4,0,0,0,0,2,0,0
"1884","Max Kilman",1350,14,6,12,2,0,6,12,NA,6,26,13,13,14,28,62,0
"1885","Max Kruse",272,1,1,0,1,0,0,1,NA,1,2,1,1,0,1,1,0
"1886","Maxence Caqueret",973,33,18,8,15,10,18,42,NA,24,14,1,13,10,43,9,0
"1887","Maxence Lacroix",804,7,4,5,2,0,4,9,NA,5,12,3,9,14,21,42,0
"1888","Maxi Gómez",127,0,0,0,0,0,0,0,NA,0,0,0,0,0,0,2,0
"1889","Maxim Leitsch",620,8,6,5,3,0,3,4,NA,1,7,4,3,18,26,24,1
"1890","Maxime Busi",507,8,6,4,4,0,6,12,NA,6,6,2,4,5,13,11,0
"1891","Maxime Dupé",1350,0,0,0,0,0,0,0,NA,0,0,0,0,0,0,5,2
"1892","Maxime Estève",810,15,8,10,3,2,6,7,NA,1,19,11,8,24,39,53,0
"1893","Maxime Gonalons",529,19,11,7,10,2,7,15,NA,8,5,1,4,4,23,2,0
"1894","Maxime Le Marchand",967,22,16,10,11,1,10,16,NA,6,8,5,3,20,42,38,0
"1895","Maxime Lopez",993,20,7,12,6,2,7,30,265,23,11,1,10,11,31,10,0
"1896","Maximilian Arnold",1307,29,14,12,12,5,12,21,NA,9,23,8,15,8,37,31,0
"1897","Maximilian Bauer",1039,16,10,12,4,0,10,18,NA,8,11,3,8,19,35,45,0
"1898","Maximilian Eggestein",1019,26,11,10,12,4,11,17,NA,6,17,4,13,14,40,7,0
"1899","Maximilian Mittelstädt",355,15,7,13,2,0,7,15,NA,8,7,1,6,10,25,11,0
"1900","Maximilian Philipp",116,2,1,1,1,0,1,1,NA,0,1,0,1,0,2,0,0
"1901","Maximilian Wöber",165,9,6,6,2,1,3,5,NA,2,3,1,2,0,9,5,0
"1902","Maximiliano Caufriez",789,14,9,9,5,0,10,11,NA,1,9,5,4,16,30,35,0
"1903","Maxwel Cornet",91,4,1,3,0,1,2,2,NA,0,0,0,0,0,4,0,0
"1904","Maya Yoshida",1518,21,11,11,10,0,12,17,NA,5,24,18,6,24,45,92,0
"1905","Mehdi Bourabia",1066,21,8,8,11,2,10,16,NA,6,16,8,8,18,39,23,0
"1906","Mehdi Léris",759,26,20,12,9,5,9,19,NA,10,14,0,14,9,35,5,0
"1907","Mehdi Taremi",709,9,6,2,4,3,4,12,NA,8,10,1,9,3,12,11,0
"1908","Mehdi Torabi",62,1,0,1,0,0,1,3,NA,2,1,0,1,2,3,0,0
"1909","Mehdi Zeffane",20,0,0,0,0,0,0,0,NA,0,0,0,0,0,0,0,0
"1910","Mehmet-Can Aydin",208,8,5,3,4,1,2,4,NA,2,3,0,3,4,12,4,0
"1911","Melvin Bard",927,34,19,21,10,3,21,30,NA,9,15,1,14,21,55,16,1
"1912","Memphis Depay",269,2,1,1,1,0,0,0,NA,0,2,0,2,0,2,0,0
"1913","Mergim Berisha",784,5,2,2,2,1,1,3,NA,2,10,0,10,0,5,12,0
"1914","Mërgim Vojvoda",426,5,5,2,3,0,5,6,NA,1,0,0,0,4,9,12,0
"1915","Merih Demiral",983,22,13,15,7,0,12,15,NA,3,16,5,11,16,38,43,0
"1916","Mert Müldür",6,0,0,0,0,0,0,0,NA,0,0,0,0,0,0,0,0
"1917","Meshaal Barsham",180,0,0,0,0,0,0,0,NA,0,0,0,0,0,0,1,1
"1918","Michael Estrada",225,1,0,0,1,0,0,1,NA,1,4,1,3,0,1,0,0
"1919","Michael Gregoritsch",1113,10,6,2,4,4,2,9,NA,7,10,2,8,4,14,7,0
"1920","Michael Keane",23,0,0,0,0,0,0,0,NA,0,0,0,0,0,0,4,0
"1921","Michael Olise",754,16,7,12,3,1,7,14,NA,7,16,0,16,4,20,6,0
"1922","Michael Zetterer",62,0,0,0,0,0,0,0,NA,0,0,0,0,0,0,1,0
"1923","Michail Antonio",607,3,2,0,2,1,1,2,NA,1,5,1,4,2,5,3,0
"1924","Michał Skóraś",45,0,0,0,0,0,0,0,NA,0,1,0,1,1,1,0,0
"1925","Michel Aebischer",522,1,1,0,0,1,0,3,NA,3,6,1,5,1,2,4,0
"1926","Michel Ndary Adopo",98,1,0,0,0,1,0,1,NA,1,1,1,0,0,1,0,0
"1927","Michele Castagnetti",327,11,5,5,5,1,5,10,NA,5,2,0,2,4,15,8,0
"1928","Michele Di Gregorio",1080,0,0,0,0,0,0,0,NA,0,0,0,0,1,1,5,0
"1929","Michy Batshuayi",151,1,0,0,1,0,1,1,NA,0,1,0,1,0,1,0,0
"1930","Mickaël Alphonse",652,15,9,9,4,2,9,15,NA,6,9,2,7,17,32,14,1
"1931","Mickaël Barreto",144,6,4,1,4,1,2,4,NA,2,1,0,1,1,7,0,0
"1932","Mickael Malsa",39,1,1,1,0,0,0,3,NA,3,1,1,0,1,2,2,0
"1933","Mickey van de Ven",1350,20,16,13,7,0,12,16,NA,4,15,8,7,15,35,48,2
"1934","Miguel Almirón",1255,24,14,8,9,7,8,13,NA,5,13,2,11,2,26,6,0
"1935","Miguel Gutiérrez",908,13,6,8,4,1,4,7,NA,3,8,0,8,5,18,17,0
"1936","Miguel Veloso",667,14,2,10,3,1,6,10,NA,4,16,5,11,4,18,8,0
"1937","Miha Blažič",855,3,3,3,0,0,3,8,NA,5,11,8,3,5,8,25,1
"1938","Mikael Ellertsson",149,3,2,0,3,0,0,3,NA,3,1,0,1,2,5,0,0
"1939","Mike Maignan",810,0,0,0,0,0,0,0,NA,0,0,0,0,1,1,2,0
"1940","Mikel Balenziaga",45,2,2,0,1,1,2,2,100,0,0,0,0,1,3,1,0
"1941","Mikel Merino",1124,33,19,12,17,4,15,25,NA,10,15,5,10,13,46,32,0
"1942","Mikel Vesga",925,25,15,8,13,4,12,35,NA,23,13,3,10,16,41,13,1
"1943","Miki Yamane",61,1,0,0,1,0,0,0,NA,0,2,0,2,2,3,0,0
"1944","Mikkel Damsgaard",417,12,9,7,4,1,4,16,NA,12,6,0,6,4,16,6,0
"1945","Mikkel Desler",1005,38,21,19,12,7,19,31,NA,12,14,2,12,15,53,19,1
"1946","Milad Mohammadi",196,10,3,7,3,0,3,4,250,1,2,0,2,1,11,6,0
"1947","Milan Borjan",180,0,0,0,0,0,0,0,NA,0,0,0,0,0,0,2,0
"1948","Milan Đurić",193,0,0,0,0,0,0,0,NA,0,1,1,0,0,0,2,0
"1949","Milan Havel",424,12,5,6,3,3,7,8,NA,1,6,0,6,4,16,12,0
"1950","Milan Škriniar",1644,30,20,16,10,4,18,29,NA,11,24,18,6,14,44,52,3
"1951","Miloš Degenek",112,5,3,5,0,0,5,6,NA,1,2,1,1,1,6,7,0
"1952","Miloš Pantović",176,3,1,3,0,0,3,4,NA,1,2,0,2,0,3,4,0
"1953","Miloš Veljković",1202,20,11,14,6,0,14,20,NA,6,14,11,3,17,37,56,0
"1954","Mislav Oršić",496,5,4,1,4,0,2,6,NA,4,1,0,1,2,7,0,0
"1955","Mitchel Bakker",1102,17,10,5,8,4,9,12,NA,3,12,2,10,10,27,16,2
"1956","Mitchell Duke",199,0,0,0,0,0,0,0,NA,0,3,0,3,2,2,1,0
"1957","Mitchell van Bergen",427,8,3,3,4,1,5,11,NA,6,3,2,1,4,12,5,0
"1958","Mitchell Weiser",1287,42,27,16,20,6,17,33,NA,16,26,2,24,15,57,18,0
"1959","Moanes Dabbur",422,5,3,2,3,0,3,4,NA,1,2,0,2,2,7,0,0
"1960","Modou Biramé Ndiaye",182,4,1,3,1,0,2,8,NA,6,2,0,2,6,10,4,0
"1961","Mohamed Achi",36,1,1,1,0,0,1,1,NA,0,0,0,0,0,1,0,0
"1962","Mohamed Ali Ben Romdhane",73,5,3,1,4,0,2,2,100,0,1,0,1,0,5,0,0
"1963","Mohamed Ali Cho",243,4,2,4,0,0,0,1,NA,1,5,0,5,2,6,2,0
"1964","Mohamed Camara",1021,35,23,13,19,3,18,36,NA,18,20,2,18,17,52,9,0
"1965","Mohamed Dräger",132,5,3,3,2,0,4,4,200,0,0,0,0,1,6,4,0
"1966","Mohamed Elneny",95,1,1,1,0,0,1,1,NA,0,0,0,0,0,1,0,0
"1967","Mohamed Elyounoussi",985,22,13,11,8,3,9,19,NA,10,19,2,17,9,31,20,0
"1968","Mohamed Kanno",270,6,2,5,1,0,2,3,NA,1,3,1,2,2,8,7,0
"1969","Mohamed Lamine Bayo",139,1,1,0,0,1,0,6,NA,6,0,0,0,0,1,0,0
"1970","Mohamed Salah",1680,7,5,2,2,3,4,9,NA,5,7,0,7,4,11,2,0
"1971","Mohamed Simakan",1152,22,14,9,10,3,14,24,NA,10,11,2,9,19,41,36,0
"1972","Mohamed Tijani",168,2,0,0,2,0,0,1,NA,1,3,1,2,2,4,10,0
"1973","Mohamed Youssouf",846,19,10,8,8,3,7,11,NA,4,8,1,7,20,39,19,0
"1974","Mohammad Abu Fani",400,9,6,6,1,2,3,8,NA,5,7,2,5,3,12,0,0
"1975","Mohammed Al-Breik",65,1,0,1,0,0,0,0,NA,0,2,0,2,1,2,4,0
"1976","Mohammed Al-Owais",270,0,0,0,0,0,0,1,NA,1,0,0,0,0,0,4,0
"1977","Mohammed Daramy",443,2,1,1,1,0,1,3,NA,2,2,1,1,4,6,0,0
"1978","Mohammed Muntari",63,2,2,1,1,0,1,1,NA,0,0,0,0,0,2,2,0
"1979","Mohammed Salisu",1440,39,22,28,10,1,17,23,NA,6,41,18,23,17,56,83,1
"1980","Mohammed Waad",28,0,0,0,0,0,0,0,NA,0,1,0,1,1,1,1,0
"1981","Moi Gómez",1139,10,6,5,4,1,6,11,NA,5,6,2,4,6,16,2,0
"1982","Moise Kean",532,9,7,2,6,1,3,5,NA,2,2,0,2,4,13,1,0
"1983","Moisés Caicedo",1514,49,24,15,26,8,18,27,NA,9,20,2,18,21,70,13,2
"1984","Moises Parra Gutierrez",10,1,0,0,1,0,0,0,NA,0,0,0,0,0,1,0,0
"1985","Monchu",659,23,13,8,11,4,9,16,NA,7,12,7,5,7,30,7,1
"1986","Montassar Talbi",1620,24,13,18,6,0,13,17,NA,4,21,10,11,15,39,92,1
"1987","Morgan Gibbs-White",1216,11,7,6,2,3,7,11,NA,4,5,2,3,8,19,9,0
"1988","Morgan Sanson",1,0,0,0,0,0,0,0,NA,0,0,0,0,0,0,0,0
"1989","Moritz Jenz",540,8,4,5,3,0,4,8,NA,4,16,11,5,8,16,15,1
"1990","Morten Hjulmand",1084,29,18,17,12,0,9,14,NA,5,19,5,14,29,58,26,0
"1991","Morten Thorsby",433,13,7,4,8,1,7,9,NA,2,4,1,3,1,14,9,0
"1992","Morteza Pouraliganji",270,2,2,0,1,1,1,2,NA,1,5,3,2,6,8,10,0
"1993","Mory Diaw",1350,0,0,0,0,0,0,1,NA,1,0,0,0,0,0,8,2
"1994","Moses Simon",1007,11,7,4,4,3,4,5,NA,1,7,1,6,3,14,3,0
"1995","Mostafa Mohamed",762,4,2,1,1,2,2,6,NA,4,13,1,12,1,5,9,0
"1996","Mouctar Diakhaby",791,14,8,9,5,0,6,8,NA,2,10,6,4,7,21,31,1
"1997","Mouhamadou Diarra",437,8,5,4,3,1,6,10,NA,4,4,1,3,4,12,5,0
"1998","Moumi Ngamaleu",10,0,0,0,0,0,0,0,NA,0,0,0,0,0,0,0,0
"1999","Mounaim El Idrissy",1062,16,11,2,8,6,6,14,NA,8,3,0,3,3,19,10,0
"2000","Moussa Dembélé",576,5,4,1,2,2,4,5,NA,1,5,0,5,0,5,3,0
"2001","Moussa Diaby",1756,14,8,4,8,2,8,16,NA,8,8,0,8,3,17,2,0
"2002","Moussa Diarra",553,13,5,5,7,1,4,7,NA,3,10,4,6,11,24,13,0
"2003","Moussa Djenepo",526,16,9,11,4,1,8,19,NA,11,9,2,7,10,26,6,0
"2004","Moussa Niakhate",160,1,0,1,0,0,1,4,33.3,3,1,1,0,1,2,18,0
"2005","Moussa Sissoko",698,13,8,10,2,1,7,8,NA,1,8,4,4,8,21,7,0
"2006","Muhammed Damar",128,6,3,1,2,3,1,2,NA,1,3,0,3,0,6,0,0
"2007","Muhammed Saracevic Cham",865,15,7,7,2,6,7,16,NA,9,7,0,7,5,20,3,0
"2008","Munir",90,0,0,0,0,0,0,0,NA,0,0,0,0,0,0,0,0
"2009","Munir El Haddadi",234,2,1,1,0,1,1,2,NA,1,4,0,4,1,3,0,0
"2010","Musa Barrow",554,4,2,3,1,0,2,2,NA,0,12,0,12,0,4,2,0
"2011","Musab Kheder",6,1,1,1,0,0,0,0,NA,0,0,0,0,0,1,0,0
"2012","Mykhailo Mudryk",516,6,1,4,2,0,3,6,NA,3,2,0,2,0,6,1,0
"2013","Mykola Matviyenko",540,10,4,9,1,0,6,9,NA,3,13,4,9,9,19,35,0
"2014","Myron Boadu",18,0,0,0,0,0,0,0,NA,0,0,0,0,0,0,1,0
"2015","Myziane Maolida",68,1,1,1,0,0,1,2,100,1,0,0,0,0,1,1,0
"2016","N'Golo Kanté",174,5,3,1,4,0,2,4,133.3,2,1,0,1,3,8,0,0
"2017","Na Sang-ho",119,4,1,0,3,1,1,1,NA,0,0,0,0,0,4,2,0
"2018","Nabil Bentaleb",1073,40,20,18,18,4,19,27,NA,8,14,3,11,24,64,11,2
"2019","Nabil Fekir",426,5,1,2,1,2,1,4,NA,3,3,0,3,0,5,0,0
"2020","Nabil Touaizi",3,0,0,0,0,0,0,0,NA,0,0,0,0,0,0,0,0
"2021","Nacho",420,4,2,1,3,0,1,3,NA,2,7,6,1,12,16,10,0
"2022","Nacho Vidal",891,22,12,14,3,5,14,26,NA,12,15,2,13,17,39,21,1
"2023","Nader Ghandri",90,2,1,2,0,0,1,1,100,0,4,4,0,1,3,4,0
"2024","Nadiem Amiri",545,9,3,2,4,3,7,13,NA,6,6,0,6,5,14,7,1
"2025","Nadir Zortea",189,10,5,3,7,0,3,4,NA,1,3,0,3,0,10,4,0
"2026","Nahuel Molina",1599,31,17,14,12,5,16,30,NA,14,18,3,15,7,38,24,1
"2027","Naïm Sliti",114,3,1,0,2,1,0,1,NA,1,0,0,0,0,3,1,0
"2028","Nampalys Mendy",334,4,4,3,1,0,2,3,NA,1,5,1,4,6,10,3,0
"2029","Naouirou Ahamada",1231,16,11,7,6,3,8,19,NA,11,13,4,9,8,24,6,0
"2030","Nasser Al-Dawsari",5,2,1,2,0,0,0,0,NA,0,0,0,0,0,2,0,0
"2031","Nathan Aké",1024,13,7,7,6,0,6,7,NA,1,10,5,5,8,21,19,0
"2032","Nathan Collins",1022,14,7,12,2,0,7,14,NA,7,17,13,4,13,27,46,0
"2033","Nathan N'Goumou",265,8,4,5,3,0,4,8,NA,4,2,0,2,2,10,2,0
"2034","Nathan Patterson",767,34,14,22,9,3,20,27,744,7,14,3,11,10,44,27,0
"2035","Nathan Redmond",1,0,0,0,0,0,0,0,NA,0,0,0,0,0,0,0,0
"2036","Nathanael Mbuku",66,2,1,2,0,0,2,2,NA,0,0,0,0,0,2,0,0
"2037","Nathaniel Atkinson",84,4,3,3,1,0,4,6,66.7,2,1,1,0,1,5,2,1
"2038","Nathaniel Chalobah",11,1,1,1,0,0,1,1,NA,0,0,0,0,0,1,2,0
"2039","Nathaniel Clyne",580,9,5,5,3,1,6,9,NA,3,4,1,3,5,14,9,0
"2040","Nathaniel Phillips",66,2,1,0,2,0,2,2,NA,0,0,0,0,2,4,1,0
"2041","Nawaf Al Abed",88,0,0,0,0,0,0,0,NA,0,0,0,0,1,1,0,0
"2042","Nayef Aguerd",256,3,1,2,1,0,1,2,NA,1,4,3,1,3,6,6,0
"2043","Neal Maupay",553,5,2,1,1,3,1,1,NA,0,0,0,0,1,6,0,0
"2044","Neco Williams",1282,49,32,34,9,6,26,42,NA,16,20,5,15,30,79,28,0
"2045","Nedim Bajrami",710,4,2,2,2,0,2,4,NA,2,3,0,3,4,8,4,0
"2046","Neeskens Kebano",713,12,5,7,5,0,7,13,NA,6,12,0,12,1,13,8,0
"2047","Nehuén Pérez",966,24,14,19,4,1,13,16,NA,3,11,6,5,10,34,43,1
"2048","Nélson Semedo",675,26,19,19,6,1,14,18,NA,4,11,4,7,5,31,19,0
"2049","Nelson Weiper",4,0,0,0,0,0,0,0,NA,0,0,0,0,0,0,0,0
"2050","Nemanja Gudelj",1587,18,13,12,3,3,8,19,NA,11,21,15,6,14,32,59,1
"2051","Nemanja Maksimović",809,16,6,5,8,3,6,11,NA,5,19,9,10,12,28,11,0
"2052","Nemanja Matić",758,22,11,10,10,2,9,17,NA,8,9,3,6,12,34,12,0
"2053","Nemanja Radonjić",723,1,1,1,0,0,0,2,NA,2,2,0,2,2,3,2,0
"2054","Néstor Araujo",90,1,1,1,0,0,1,1,100,0,0,0,0,3,4,1,0
"2055","Neta Lavi",469,23,17,12,10,1,7,20,NA,13,5,0,5,9,32,6,0
"2056","Neto",675,0,0,0,0,0,0,0,NA,0,0,0,0,0,0,1,0
"2057","Neto Borges",991,28,18,15,11,2,15,26,836.7,11,17,4,13,15,43,28,0
"2058","Neven Đurasek",91,1,0,0,0,1,0,0,NA,0,1,1,0,4,5,2,0
"2059","Neymar",1608,18,10,6,6,6,7,23,NA,16,9,1,8,4,22,0,1
"2060","Nick Pope",1350,0,0,0,0,0,0,2,NA,2,0,0,0,0,0,13,1
"2061","Niclas Füllkrug",1250,2,1,0,1,1,1,4,NA,3,8,4,4,0,2,17,0
"2062","Nico Elvedi",1305,25,12,18,5,2,16,21,NA,5,15,6,9,15,40,63,1
"2063","Nico Ribaudo",178,4,3,1,2,1,2,4,NA,2,2,0,2,1,5,1,0
"2064","Nico Schlotterbeck",1759,51,32,31,19,1,30,42,NA,12,29,16,13,18,69,54,2
"2065","Nico Williams",1116,15,8,6,4,5,6,10,NA,4,17,1,16,3,18,3,0
"2066","Nicola Murru",117,5,3,1,3,1,2,3,NA,1,1,0,1,1,6,1,0
"2067","Nicola Sansone",246,1,1,1,0,0,1,1,NA,0,0,0,0,0,1,1,0
"2068","Nicola Zalewski",508,9,3,4,2,3,5,13,NA,8,8,0,8,6,15,4,0
"2069","Nicolai Boilesen",100,0,0,0,0,0,0,1,NA,1,2,1,1,2,2,3,0
"2070","Nicolai Rapp",71,3,1,3,0,0,0,3,NA,3,0,0,0,0,3,1,0
"2071","Nicolás Capaldo",270,8,4,5,2,1,5,8,NA,3,9,0,9,4,12,9,0
"2072","Nicolas Cozza",1236,38,21,27,9,2,26,36,NA,10,10,5,5,21,59,34,1
"2073","Nicolás De La Cruz",13,0,0,0,0,0,0,0,NA,0,0,0,0,0,0,0,0
"2074","Nicolás Domínguez",788,27,14,14,12,1,12,23,NA,11,12,2,10,6,33,4,0
"2075","Nicolás Ezequiel Fernández",294,14,8,6,4,4,7,12,NA,5,4,0,4,5,19,2,0
"2076","Nicolás González",704,11,5,2,6,3,3,9,NA,6,6,2,4,4,15,8,0
"2077","Nicolas Haas",670,16,8,6,5,5,7,13,NA,6,7,2,5,3,19,12,0
"2078","Nicolas Höfler",1292,31,13,13,18,0,15,28,NA,13,21,7,14,20,51,20,0
"2079","Nicolas Jackson",789,7,6,2,5,0,1,4,NA,3,10,2,8,1,8,3,0
"2080","Nicolas Nkoulou",180,2,0,2,0,0,0,2,NA,2,2,0,2,5,7,8,1
"2081","Nicolás Otamendi",810,19,15,16,3,0,9,14,NA,5,13,5,8,14,33,33,0
"2082","Nicolas Pallois",1098,43,31,33,8,2,27,37,NA,10,22,12,10,17,60,62,2
"2083","Nicolas Pépé",889,11,4,8,1,2,5,13,NA,8,9,0,9,1,12,1,0
"2084","Nicolas Seiwald",540,19,14,13,5,1,9,15,383.4,6,14,3,11,8,27,5,0
"2085","Nicolás Tagliafico",1429,52,34,22,23,7,30,38,NA,8,23,4,19,29,81,16,0
"2086","Nicolò Barella",1588,25,14,13,11,1,10,22,NA,12,19,3,16,7,32,11,0
"2087","Nicolò Cambiaghi",242,7,5,3,2,2,2,4,NA,2,3,0,3,2,9,3,0
"2088","Nicolò Casale",416,14,8,8,6,0,8,10,NA,2,7,6,1,6,20,15,0
"2089","Nicolò Fagioli",285,4,2,2,1,1,0,3,NA,3,5,1,4,3,7,0,0
"2090","Nicolò Rovella",616,18,13,8,9,1,8,13,NA,5,11,1,10,15,33,4,0
"2091","Nicolò Zaniolo",621,5,3,2,2,1,3,6,NA,3,8,0,8,0,5,0,0
"2092","Nikita Rukavytsya",47,0,0,0,0,0,0,1,NA,1,1,0,1,0,0,0,0
"2093","Niklas Schmidt",206,5,0,3,2,0,1,4,NA,3,2,0,2,0,5,1,0
"2094","Niklas Stark",644,18,14,10,8,0,9,13,NA,4,6,2,4,11,29,31,0
"2095","Niklas Süle",1462,19,17,16,2,1,9,13,NA,4,20,11,9,12,31,42,0
"2096","Niklas Tauer",93,2,1,2,0,0,1,3,NA,2,2,1,1,2,4,4,0
"2097","Niko Gießelmann",656,6,1,4,2,0,5,15,NA,10,11,1,10,3,9,14,0
"2098","Nikola Milenković",928,23,15,8,11,4,12,15,NA,3,13,6,7,12,35,31,1
"2099","Nikola Moro",124,4,2,3,1,0,2,2,NA,0,2,0,2,1,5,1,0
"2100","Nikola Soldo",413,8,4,5,3,0,3,5,NA,2,2,2,0,4,12,20,0
"2101","Nikola Vlašić",1187,12,7,3,6,3,4,9,NA,5,6,0,6,3,15,4,0
"2102","Nikolas Nartey",49,2,1,1,0,1,0,2,NA,2,0,0,0,0,2,0,0
"2103","Nils Petersen",162,4,3,0,1,3,1,2,NA,1,7,2,5,1,5,6,0
"2104","Noa Lang",156,3,1,0,1,2,1,2,NA,1,2,0,2,0,3,1,0
"2105","Noah Fadiga",650,12,7,6,5,1,5,12,NA,7,5,2,3,11,23,8,0
"2106","Noah Holm",98,4,2,2,1,1,1,2,NA,1,0,0,0,0,4,2,0
"2107","Noah Okafor",484,4,0,0,3,1,3,4,NA,1,5,0,5,0,4,0,0
"2108","Noah Weißhaupt",111,4,1,1,3,0,1,3,NA,2,2,0,2,2,6,3,0
"2109","Norbert Gyömbér",719,14,11,11,3,0,7,11,NA,4,15,10,5,11,25,37,0
"2110","Nordi Mukiele",783,21,15,9,6,6,14,21,NA,7,14,6,8,12,33,11,0
"2111","Nordine Kandil",39,3,2,1,2,0,0,2,NA,2,1,0,1,1,4,0,0
"2112","Nouhou Tolo",180,4,3,4,0,0,0,0,NA,0,3,1,2,5,9,5,0
"2113","Noussair Mazraoui",1097,37,24,15,12,10,18,28,NA,10,13,3,10,10,47,32,0
"2114","Nuno da Costa",801,18,11,4,11,3,4,15,NA,11,9,0,9,9,27,4,0
"2115","Nuno Mendes",1061,29,21,19,9,1,22,31,NA,9,16,2,14,11,40,13,0
"2116","Nuno Santos",295,7,5,7,0,0,6,7,NA,1,4,1,3,2,9,8,0
"2117","Nuno Tavares",1640,43,24,15,17,11,19,34,NA,15,24,3,21,12,55,22,0
"2118","Obite N'Dicka",1882,24,16,14,8,2,15,23,NA,8,31,13,18,24,48,108,0
"2119","Odilon Kossonou",949,16,11,11,4,1,7,7,NA,0,10,4,6,9,25,39,0
"2120","Odisseas Vlachodimos",540,0,0,0,0,0,0,1,NA,1,1,0,1,0,0,2,0
"2121","Odsonne Édouard",767,11,5,4,5,2,4,5,NA,1,6,4,2,2,13,9,0
"2122","Ofri Arad",22,2,2,1,0,1,1,1,NA,0,1,0,1,1,3,0,0
"2123","Ohis Felix Uduokhai",436,7,6,4,2,1,4,7,NA,3,7,6,1,8,15,27,0
"2124","Oier Zarraga",225,0,0,0,0,0,0,2,NA,2,1,0,1,1,1,0,0
"2125","Oihan Sancet",938,9,4,1,5,3,4,15,NA,11,4,0,4,3,12,3,0
"2126","Ola Aina",580,13,10,3,7,3,6,10,NA,4,7,1,6,7,20,17,0
"2127","Oleh Ocheretko",14,2,2,0,1,1,0,1,0,1,0,0,0,0,2,0,0
"2128","Oleksandr Zinchenko",559,14,6,3,5,6,6,14,NA,8,3,0,3,6,20,10,1
"2129","Oleksandr Zubkov",365,7,4,4,2,1,0,2,NA,2,4,0,4,4,11,3,0
"2130","Oliver Abildgaard",63,4,3,3,1,0,2,4,66.7,2,1,0,1,0,4,1,0
"2131","Oliver Baumann",1350,0,0,0,0,0,0,0,NA,0,0,0,0,0,0,8,0
"2132","Oliver Burke",254,1,0,0,0,1,0,0,NA,0,2,0,2,0,1,0,0
"2133","Oliver Christensen",1350,1,0,1,0,0,0,1,NA,1,0,0,0,0,1,11,1
"2134","Oliver Skipp",161,2,2,1,1,0,1,4,NA,3,2,0,2,1,3,3,0
"2135","Óliver Torres",850,15,9,3,6,6,8,19,NA,11,13,2,11,7,22,3,0
"2136","Oliver Zandén",146,2,1,1,0,1,2,5,NA,3,0,0,0,1,3,7,0
"2137","Olivier Giroud",1311,4,3,1,3,0,2,6,NA,4,8,1,7,3,7,12,0
"2138","Ollie Watkins",1172,10,6,1,7,2,4,12,NA,8,9,0,9,5,15,9,0
"2139","Omar Alderete",135,0,0,0,0,0,0,3,NA,3,1,1,0,2,2,9,0
"2140","Omar Colley",1035,9,6,6,3,0,5,7,NA,2,4,3,1,17,26,49,1
"2141","Omar El Hilali",92,3,2,3,0,0,1,2,NA,1,1,0,1,1,4,6,0
"2142","Omar Marmoush",685,7,5,3,0,4,4,9,NA,5,8,0,8,5,12,2,0
"2143","Omar Mascarell",1014,18,10,9,8,1,8,22,NA,14,14,4,10,14,32,19,1
"2144","Omer Atzili",308,7,3,2,3,2,2,9,NA,7,2,0,2,3,10,1,0
"2145","Ondrej Duda",689,9,8,2,5,2,4,11,NA,7,7,1,6,2,11,3,0
"2146","Orbelín Pineda",76,4,3,2,1,1,2,3,66.7,1,2,0,2,0,4,1,0
"2147","Orel Mangala",267,6,3,4,1,1,3,7,NA,4,4,0,4,1,7,1,0
"2148","Oriol Romeu",1064,34,16,19,11,4,11,21,NA,10,15,4,11,15,49,13,0
"2149","Ørjan Nyland",90,0,0,0,0,0,0,0,NA,0,0,0,0,0,0,0,0
"2150","Orri Steinn Óskarsson",22,0,0,0,0,0,0,0,NA,0,0,0,0,0,0,0,0
"2151","Óscar de Marcos",1078,17,10,7,7,3,11,21,NA,10,12,4,8,6,23,18,0
"2152","Óscar Duarte",180,3,2,3,0,0,2,2,NA,0,2,0,2,4,7,7,0
"2153","Óscar Gil",868,23,13,12,7,4,8,13,NA,5,10,3,7,9,32,15,0
"2154","Óscar Mingueza",478,19,9,15,3,1,13,14,NA,1,5,3,2,4,23,11,0
"2155","Óscar Plano",829,16,10,4,5,7,4,8,NA,4,9,1,8,12,28,9,0
"2156","Óscar Rodríguez Arnaiz",999,19,16,7,9,3,7,12,NA,5,5,1,4,13,32,7,0
"2157","Óscar Trejo",840,15,14,3,6,6,3,8,NA,5,10,2,8,2,17,3,0
"2158","Oscar Ureña",100,4,2,2,2,0,2,3,NA,1,2,0,2,1,5,0,0
"2159","Óscar Valentín",957,43,22,12,23,8,21,37,NA,16,25,5,20,19,62,12,0
"2160","Osman Bukari",14,0,0,0,0,0,0,0,NA,0,0,0,0,0,0,0,0
"2161","Otávio",504,18,14,9,9,0,7,16,NA,9,9,0,9,0,18,3,0
"2162","Oumar Gonzalez",946,23,13,17,4,2,13,16,NA,3,11,5,6,23,46,23,0
"2163","Oumar Solet",266,5,4,3,1,1,2,2,NA,0,7,3,4,3,8,13,0
"2164","Ousmane Camara",180,2,1,1,1,0,2,6,66.6,4,3,1,2,2,4,7,0
"2165","Ousmane Dembélé",1441,29,19,9,10,10,7,16,NA,9,8,0,8,3,32,2,0
"2166","Owen Bevan",9,0,0,0,0,0,0,0,NA,0,0,0,0,0,0,0,0
"2167","Owen Wijndal",76,1,0,0,1,0,1,1,NA,0,1,0,1,2,3,4,0
"2168","Ozan Kabak",1256,24,15,16,8,0,5,12,NA,7,20,10,10,31,55,36,0
"2169","Pablo Barrios",25,0,0,0,0,0,0,0,NA,0,0,0,0,0,0,0,0
"2170","Pablo Durán",29,0,0,0,0,0,0,0,NA,0,1,1,0,1,1,2,0
"2171","Pablo Fornals",776,13,7,5,4,4,5,20,NA,15,7,0,7,9,22,7,0
"2172","Pablo Ibáñez",35,1,0,1,0,0,0,0,NA,0,2,0,2,0,1,3,0
"2173","Pablo Maffeo",1017,17,15,12,4,1,10,20,NA,10,13,7,6,10,27,24,0
"2174","Pablo Marí",709,11,5,9,2,0,3,5,NA,2,2,2,0,8,19,29,0
"2175","Pablo Marín",106,1,1,0,1,0,0,0,NA,0,1,0,1,0,1,1,0
"2176","Pablo Muñoz",12,0,0,0,0,0,0,1,NA,1,0,0,0,0,0,0,0
"2177","Pablo Rodríguez",54,2,1,2,0,0,0,0,NA,0,3,0,3,0,2,0,0
"2178","Pablo Rosario",673,12,4,5,5,2,5,7,NA,2,6,3,3,12,24,16,0
"2179","Pablo Sarabia",410,5,4,2,2,1,2,8,NA,6,4,0,4,2,7,0,0
"2180","Pablo Torre",109,2,2,0,2,0,0,0,NA,0,1,1,0,1,3,0,1
"2181","Panagiotis Retsos",122,5,4,2,2,1,3,3,NA,0,4,1,3,2,7,3,0
"2182","Paolo Ghiglione",377,5,3,3,2,0,3,8,233.3,5,7,4,3,3,8,7,0
"2183","Papa Ndiaga Yade",320,5,4,3,1,1,4,10,NA,6,9,2,7,7,12,5,0
"2184","Pape Abou Cissé",105,0,0,0,0,0,0,0,NA,0,2,2,0,2,2,6,0
"2185","Pape Gueye",486,17,6,9,8,0,5,10,NA,5,7,1,6,5,22,2,0
"2186","Pape Matar Sarr",14,1,1,0,1,0,0,0,NA,0,0,0,0,0,1,0,0
"2187","Papu Gómez",954,8,6,2,5,1,2,7,NA,5,5,1,4,8,16,5,0
"2188","Pascal Groß",1192,21,13,10,8,3,6,18,NA,12,15,3,12,5,26,5,0
"2189","Pascal Stenzel",228,9,5,6,3,0,4,6,NA,2,5,1,4,4,13,3,0
"2190","Pascal Struijk",1164,42,30,22,14,6,25,42,704.2,17,17,4,13,21,63,30,0
"2191","Pasquale Mazzocchi",1019,17,8,11,3,3,7,16,NA,9,5,2,3,5,22,19,1
"2192","Pathé Ciss",744,24,20,7,13,4,8,17,NA,9,12,9,3,13,37,23,0
"2193","Patric",752,11,7,7,2,2,7,9,NA,2,11,9,2,5,16,24,1
"2194","Patrick Bamford",429,3,2,0,3,0,1,8,NA,7,2,1,1,0,3,5,0
"2195","Patrick Berg",25,0,0,0,0,0,0,1,NA,1,0,0,0,1,1,0,0
"2196","Patrick Ciurria",568,6,3,4,2,0,2,9,NA,7,4,0,4,0,6,3,0
"2197","Patrick Herrmann",116,4,1,3,1,0,1,1,NA,0,2,0,2,1,5,0,0
"2198","Patrick Osterhage",343,7,5,1,5,1,4,6,NA,2,5,2,3,4,11,8,0
"2199","Patrick Pentz",630,0,0,0,0,0,0,0,NA,0,0,0,0,0,0,1,0
"2200","Patrick Wimmer",516,14,9,5,5,4,2,12,NA,10,10,2,8,4,18,5,0
"2201","Patrik Schick",1304,2,2,0,1,1,0,2,NA,2,6,1,5,2,4,8,0
"2202","Patson Daka",642,7,4,2,5,0,1,3,NA,2,6,2,4,3,10,6,0
"2203","Pau López",1620,0,0,0,0,0,0,1,NA,1,0,0,0,0,0,2,0
"2204","Pau Torres",1170,9,5,4,4,1,6,8,NA,2,11,10,1,3,12,53,2
"2205","Paul Akouokou",238,9,5,7,2,0,7,9,NA,2,0,0,0,5,14,2,1
"2206","Paul Bernardoni",630,1,0,1,0,0,1,1,NA,0,0,0,0,0,1,2,1
"2207","Paul Jaeckel",800,15,11,7,8,0,11,22,NA,11,7,2,5,13,28,30,1
"2208","Paul Joly",867,33,21,21,10,2,19,35,NA,16,13,2,11,24,57,29,2
"2209","Paul Mukairu",44,2,2,1,1,0,2,2,NA,0,0,0,0,0,2,0,0
"2210","Paul Seguin",260,6,3,5,0,1,4,8,NA,4,4,0,4,0,6,0,0
"2211","Paul Wanner",48,3,1,1,2,0,1,1,NA,0,0,0,0,1,4,1,0
"2212","Paulinho",367,5,4,2,3,0,2,3,NA,1,3,0,3,0,5,8,0
"2213","Paulo Dybala",597,5,1,0,4,1,4,8,NA,4,4,0,4,4,9,1,0
"2214","Paulo Gazzaniga",360,0,0,0,0,0,0,0,NA,0,0,0,0,0,0,3,0
"2215","Paulo Otávio",1129,39,23,27,9,3,22,29,NA,7,29,4,25,19,58,40,1
"2216","Pavel Bucha",364,6,3,4,2,0,5,9,NA,4,3,0,3,2,8,2,0
"2217","Pavel Kadeřábek",600,8,6,3,4,1,4,5,NA,1,4,1,3,5,13,8,1
"2218","Paweł Dawidowicz",360,7,3,4,2,1,3,4,NA,1,3,2,1,3,10,10,0
"2219","Pedri",1572,30,14,11,17,2,11,40,NA,29,26,0,26,16,46,9,1
"2220","Pedro",449,6,2,4,1,1,3,5,NA,2,3,1,2,2,8,1,0
"2221","Pedro Bigas",969,17,10,14,3,0,7,12,NA,5,14,6,8,19,36,44,0
"2222","Pedro Chirivella",1107,15,11,7,6,2,6,19,NA,13,9,1,8,12,27,0,0
"2223","Pedro Gonçalves",363,8,4,3,3,2,5,7,NA,2,5,0,5,3,11,0,0
"2224","Pedro Neto",599,8,6,3,2,3,5,11,NA,6,2,0,2,3,11,1,0
"2225","Pedro Obiang",151,4,1,1,3,0,2,3,NA,1,1,0,1,3,7,7,0
"2226","Pedro Porro",392,14,10,9,3,2,11,14,341.7,3,7,1,6,4,18,12,0
"2227","Pep Chavarría",66,0,0,0,0,0,0,1,NA,1,1,0,1,0,0,4,0
"2228","Pepe",360,5,2,5,0,0,1,2,NA,1,2,2,0,7,12,15,0
"2229","Pepê",506,12,9,11,1,0,6,15,200,9,3,2,1,4,16,6,0
"2230","Pepín",114,2,1,0,0,2,1,3,NA,2,2,0,2,2,4,0,0
"2231","Pere Milla",779,16,9,10,4,2,8,19,NA,11,7,1,6,5,21,6,1
"2232","Perr Schuurs",540,14,7,5,7,2,5,7,NA,2,5,3,2,11,25,27,0
"2233","Pervis Estupiñán",901,21,11,13,4,4,12,18,NA,6,10,2,8,16,37,18,0
"2234","Petar Bočkaj",39,1,0,0,0,1,0,0,NA,0,0,0,0,0,1,0,0
"2235","Petar Musa",118,0,0,0,0,0,0,0,NA,0,3,1,2,1,1,0,0
"2236","Petar Stojanović",857,27,13,14,9,4,19,29,NA,10,9,1,8,8,35,33,0
"2237","Peter Ankersen",25,0,0,0,0,0,0,0,NA,0,0,0,0,0,0,0,0
"2238","Péter Gulácsi",732,0,0,0,0,0,0,0,NA,0,0,0,0,0,0,2,2
"2239","Peter Pekarík",8,0,0,0,0,0,0,0,NA,0,2,1,1,0,0,2,0
"2240","Petko Hristov",297,4,3,2,2,0,4,7,NA,3,3,2,1,4,8,11,0
"2241","Phil Foden",1304,12,6,7,4,1,7,9,NA,2,17,1,16,8,20,4,0
"2242","Philip Billing",1133,32,17,14,11,7,7,15,NA,8,23,5,18,10,42,25,0
"2243","Philipp Förster",652,20,14,7,9,4,6,15,NA,9,11,0,11,2,22,4,0
"2244","Philipp Hofmann",1057,3,3,0,1,2,1,4,NA,3,7,2,5,5,8,10,0
"2245","Philipp Köhn",540,1,0,1,0,0,1,1,NA,0,0,0,0,0,1,1,0
"2246","Philipp Lienhart",1347,9,6,6,3,0,5,10,NA,5,15,5,10,17,26,52,0
"2247","Philippe Coutinho",571,9,6,5,4,0,3,7,NA,4,5,0,5,2,11,1,0
"2248","Pierluigi Gollini",270,1,0,1,0,0,1,1,NA,0,0,0,0,0,1,2,0
"2249","Piero Hincapié",1727,46,28,25,19,2,22,31,NA,9,28,14,14,19,65,55,1
"2250","Pierre-Emerick Aubameyang",717,0,0,0,0,0,0,2,NA,2,4,0,4,2,2,5,1
"2251","Pierre Cornud",371,11,4,7,2,2,5,7,NA,2,4,1,3,3,14,10,0
"2252","Pierre Højbjerg",2048,31,16,19,11,1,20,39,NA,19,32,14,18,34,65,31,1
"2253","Pierre Kalulu",1440,29,15,16,12,1,12,16,NA,4,23,11,12,22,51,28,0
"2254","Pierre Kunde",66,1,0,0,1,0,0,1,0,1,0,0,0,2,3,2,0
"2255","Pierre Lees-Melou",967,26,16,12,13,1,16,40,429.9,24,16,2,14,17,43,14,0
"2256","Pierrick Capelle",581,19,13,9,9,1,11,19,NA,8,6,0,6,6,25,13,0
"2257","Pietro Pellegri",294,4,1,1,1,2,0,1,NA,1,3,1,2,0,4,1,0
"2258","Pietro Terracciano",990,1,1,1,0,0,1,1,NA,0,0,0,0,0,1,4,0
"2259","Piotr Zieliński",1361,11,6,3,6,2,3,5,NA,2,7,2,5,11,22,7,1
"2260","Pol Lirola",548,12,6,8,3,1,7,10,NA,3,1,0,1,6,18,12,0
"2261","Pol Lozano",17,0,0,0,0,0,0,0,NA,0,1,0,1,0,0,1,0
"2262","Pontus Jansson",514,3,2,2,1,0,2,3,NA,1,8,6,2,8,11,25,0
"2263","Portu",384,7,4,2,5,0,5,9,NA,4,6,0,6,2,9,3,0
"2264","Predrag Rajković",1260,0,0,0,0,0,0,1,NA,1,0,0,0,0,0,5,0
"2265","Presnel Kimpembe",716,16,8,8,6,2,7,11,NA,4,9,4,5,11,27,7,0
"2266","Przemysław Frankowski",1161,31,17,19,10,2,15,30,NA,15,14,1,13,19,50,24,0
"2267","Qazim Laçi",211,6,3,2,3,1,4,9,NA,5,5,0,5,2,8,3,0
"2268","Quentin Bernard",630,9,7,4,2,3,7,15,NA,8,9,1,8,15,24,17,0
"2269","Quentin Boisgard",184,6,2,1,4,1,3,4,NA,1,3,1,2,4,10,2,0
"2270","Quentin Merlin",1040,17,11,10,6,1,9,21,NA,12,13,3,10,14,31,12,0
"2271","Rabbi Matondo",97,1,1,1,0,0,0,1,NA,1,1,0,1,2,3,0,0
"2272","Radamel Falcao",404,3,3,1,2,0,1,4,NA,3,3,1,2,1,4,7,0
"2273","Rade Krunić",664,12,7,6,6,0,4,10,NA,6,10,4,6,7,19,7,0
"2274","Rafa Mir",715,5,1,2,2,1,1,2,NA,1,2,0,2,2,7,12,0
"2275","Rafa Silva",496,8,4,1,4,3,4,9,NA,5,3,1,2,1,9,0,0
"2276","Rafael Borré",524,7,6,1,3,3,0,8,NA,8,6,1,5,2,9,4,0
"2277","Rafael Leão",1374,3,2,0,3,0,1,4,NA,3,3,1,2,5,8,8,0
"2278","Rafael Ratão",709,23,17,9,10,4,12,20,NA,8,12,0,12,10,33,2,0
"2279","Rafael Tolói",764,18,11,12,6,0,12,18,566.7,6,13,8,5,18,36,24,0
"2280","Rafał Gikiewicz",990,1,1,1,0,0,1,1,NA,0,0,0,0,0,1,7,1
"2281","Raheem Sterling",1547,14,5,4,4,6,7,13,NA,6,14,0,14,2,16,4,0
"2282","Ramin Rezaeian",180,7,5,5,2,0,3,7,83.3,4,1,0,1,3,10,2,0
"2283","Ramón Terrats",141,2,1,0,2,0,1,4,NA,3,3,1,2,2,4,1,1
"2284","Ramy Bensebaini",1248,22,12,13,7,2,17,22,NA,5,24,8,16,14,36,58,1
"2285","Randal Kolo Muani",1661,13,11,1,5,7,1,4,NA,3,9,2,7,1,14,4,0
"2286","Randy Ntekja",67,2,2,2,0,0,1,1,NA,0,0,0,0,1,3,3,0
"2287","Rani Khedira",1213,33,15,10,18,5,14,26,NA,12,16,6,10,18,51,15,0
"2288","Raoul Bellanova",210,5,2,4,1,0,2,4,NA,2,3,1,2,2,7,7,0
"2289","Raphael Framberger",176,10,6,6,4,0,3,5,233.3,2,2,1,1,2,12,5,0
"2290","Raphaël Guerreiro",1468,26,11,11,10,5,14,24,NA,10,10,1,9,27,53,16,0
"2291","Raphael Onyedika",431,9,5,3,5,1,5,9,300,4,6,1,5,4,13,13,0
"2292","Raphaël Varane",820,13,3,11,2,0,3,6,NA,3,10,5,5,4,17,43,0
"2293","Raphinha",1022,22,18,6,6,10,10,20,NA,10,19,2,17,9,31,5,0
"2294","Rareş Ilie",148,3,3,0,1,2,2,4,NA,2,2,0,2,1,4,1,0
"2295","Rasmus Falk",189,2,1,1,1,0,1,4,NA,3,3,0,3,7,9,2,0
"2296","Rasmus Højlund",368,2,2,0,0,2,1,2,NA,1,2,0,2,0,2,0,0
"2297","Rasmus Lauritsen",15,0,0,0,0,0,0,0,NA,0,0,0,0,1,1,1,0
"2298","Rasmus Nicolaisen",1195,26,12,18,8,0,16,21,NA,5,21,16,5,29,55,73,0
"2299","Rasmus Nissen",1272,43,25,24,14,5,25,37,NA,12,18,7,11,23,66,38,0
"2300","Raúl Albiol",1159,13,9,7,5,1,7,8,NA,1,9,9,0,9,22,60,0
"2301","Raúl García",355,7,5,2,1,4,3,5,NA,2,4,1,3,1,8,5,0
"2302","Raúl Guti",647,13,8,5,7,1,6,14,NA,8,7,2,5,7,20,3,0
"2303","Raúl Jiménez",271,0,0,0,0,0,0,1,NA,1,4,0,4,1,1,3,0
"2304","Rayan Aït Nouri",666,18,10,14,3,1,3,4,NA,1,1,0,1,3,21,10,0
"2305","Rayan Cherki",222,3,2,0,1,2,3,4,NA,1,0,0,0,3,6,0,0
"2306","Rayan Raveloson",730,12,6,8,3,1,8,11,NA,3,9,1,8,15,27,14,0
"2307","Raz Meir",83,4,3,2,1,1,3,3,200,0,1,0,1,0,4,0,0
"2308","Răzvan Marin",809,12,4,8,4,0,8,13,NA,5,9,5,4,6,18,10,0
"2309","Reece James",890,24,13,12,11,1,12,15,NA,3,15,2,13,6,30,13,0
"2310","Reece Oxford",94,1,1,1,0,0,0,0,NA,0,4,3,1,1,2,5,0
"2311","Reinier",313,6,4,4,0,2,1,4,NA,3,3,0,3,1,7,2,0
"2312","Reinildo Mandava",1749,56,40,41,15,0,34,41,NA,7,29,11,18,25,81,48,0
"2313","Reiss Nelson",65,1,0,1,0,0,1,1,NA,0,0,0,0,0,1,0,0
"2314","Remi Oudin",205,8,3,3,3,2,3,6,NA,3,5,0,5,6,14,6,0
"2315","Remko Pasveer",540,0,0,0,0,0,0,0,NA,0,0,0,0,0,0,5,2
"2316","Remo Freuler",1011,24,13,10,13,1,9,16,NA,7,11,3,8,12,36,19,0
"2317","Rémy Cabella",631,15,11,4,10,1,4,8,NA,4,10,1,9,5,20,3,0
"2318","Rémy Descamps",90,0,0,0,0,0,0,0,NA,0,0,0,0,0,0,0,0
"2319","Rémy Dugimont",108,2,1,0,1,1,1,2,NA,1,3,0,3,0,2,5,0
"2320","Rémy Riou",331,1,0,1,0,0,1,1,NA,0,0,0,0,0,1,2,0
"2321","Renan Lodi",505,10,6,5,3,2,5,10,NA,5,7,2,5,10,20,13,0
"2322","Renato Sanches",462,6,0,2,2,2,3,6,NA,3,7,1,6,5,11,0,0
"2323","Renato Steffen",32,0,0,0,0,0,0,0,NA,0,1,0,1,0,0,0,0
"2324","Renato Tapia",638,18,10,9,8,1,4,11,NA,7,14,8,6,8,26,11,0
"2325","Renaud Ripart",747,27,19,12,12,3,12,27,NA,15,14,0,14,3,30,3,0
"2326","Reo Hatate",448,5,1,2,3,0,2,3,NA,1,4,0,4,3,8,5,0
"2327","Rhys Healey",60,0,0,0,0,0,0,0,NA,0,0,0,0,0,0,0,0
"2328","Riad Nouri",727,9,6,2,3,4,5,8,NA,3,2,0,2,4,13,7,0
"2329","Ricardo Esgaio",109,8,5,4,3,1,7,9,NA,2,2,0,2,0,8,1,0
"2330","Ricardo Pepi",95,1,1,1,0,0,1,1,NA,0,1,0,1,0,1,1,0
"2331","Ricardo Rodríguez",1099,27,12,15,9,3,12,14,NA,2,17,9,8,16,43,26,0
"2332","Riccardo Marchizza",17,0,0,0,0,0,0,0,NA,0,0,0,0,0,0,0,0
"2333","Riccardo Orsolini",564,9,5,4,3,2,4,10,NA,6,10,2,8,2,11,7,0
"2334","Riccardo Saponara",442,3,2,3,0,0,0,2,NA,2,1,0,1,1,4,3,0
"2335","Riccardo Sottil",432,0,0,0,0,0,0,1,NA,1,1,0,1,0,0,0,0
"2336","Richarlison",912,13,8,5,5,3,9,17,NA,8,15,2,13,6,19,6,0
"2337","Richie Laryea",134,3,1,1,2,0,2,2,200,0,2,1,1,0,3,3,0
"2338","Rick Karsdorp",395,12,6,7,4,1,10,12,NA,2,0,0,0,3,15,11,1
"2339","Rico Henry",1346,21,12,9,8,4,8,11,NA,3,15,6,9,12,33,35,0
"2340","Rico Lewis",157,3,2,2,1,0,2,2,NA,0,2,1,1,1,4,1,0
"2341","Ridle Baku",1280,30,11,18,9,3,18,30,NA,12,23,4,19,12,42,30,0
"2342","Rıdvan Yılmaz",90,1,0,1,0,0,0,2,0,2,0,0,0,3,4,2,0
"2343","Riley McGree",208,1,0,1,0,0,0,0,NA,0,4,0,4,5,6,2,0
"2344","Ritsu Doan",1155,39,21,10,20,9,17,34,NA,17,21,0,21,8,47,5,0
"2345","Riyad Mahrez",740,12,7,0,5,7,7,14,NA,7,3,0,3,2,14,2,0
"2346","Riyadh Sharahili",54,0,0,0,0,0,0,0,NA,0,1,1,0,1,1,4,0
"2347","Ró-Ró",262,6,4,3,2,1,1,2,NA,1,2,0,2,8,14,3,0
"2348","Rob Holding",14,1,1,1,0,0,0,0,NA,0,0,0,0,0,1,0,0
"2349","Robert Andrich",1387,35,24,18,14,3,14,21,NA,7,26,11,15,20,55,30,1
"2350","Robert Gumny",836,13,8,4,5,4,3,9,NA,6,4,1,3,11,24,34,0
"2351","Robert Lewandowski",1775,14,10,0,5,9,5,11,NA,6,12,1,11,2,16,12,0
"2352","Robert Ljubicic",540,13,6,7,4,2,7,18,180,11,10,1,9,10,23,7,0
"2353","Robert Sánchez",1260,0,0,0,0,0,0,0,NA,0,0,0,0,1,1,4,1
"2354","Robert Skov",956,14,9,10,4,0,7,16,NA,9,13,6,7,7,21,14,1
"2355","Robert Wagner",7,0,0,0,0,0,0,0,NA,0,1,0,1,0,0,1,0
"2356","Roberto Alvarado",18,0,0,0,0,0,0,0,NA,0,0,0,0,0,0,0,0
"2357","Roberto Arroyo",15,1,1,0,1,0,1,1,100,0,0,0,0,0,1,0,0
"2358","Roberto Firmino",1285,18,12,3,13,2,1,10,NA,9,16,1,15,10,28,4,0
"2359","Roberto Gagliardini",272,11,5,4,5,2,4,8,NA,4,9,2,7,3,14,3,0
"2360","Roberto González",54,0,0,0,0,0,0,1,NA,1,0,0,0,1,1,0,0
"2361","Roberto Navarro",155,3,2,3,0,0,0,1,NA,1,4,0,4,0,3,1,0
"2362","Roberto Pereyra",1199,19,15,11,6,2,8,20,NA,12,13,2,11,12,31,9,0
"2363","Roberto Piccoli",159,1,0,1,0,0,0,1,NA,1,1,0,1,0,1,1,0
"2364","Roberto Soriano",590,13,5,4,6,3,7,8,NA,1,10,2,8,3,16,5,0
"2365","Roberto Torres",11,0,0,0,0,0,0,0,NA,0,0,0,0,0,0,0,0
"2366","Robin Gosens",543,19,13,13,4,2,10,13,NA,3,4,0,4,4,23,8,0
"2367","Robin Knoche",1260,19,12,14,4,1,7,17,NA,10,15,8,7,12,31,58,0
"2368","Robin Koch",1215,20,12,15,5,0,11,21,NA,10,21,10,11,18,38,50,1
"2369","Robin Le Normand",816,8,5,7,1,0,2,2,NA,0,11,8,3,9,17,29,0
"2370","Robin Olsen",56,0,0,0,0,0,0,0,NA,0,0,0,0,0,0,0,0
"2371","Robin Zentner",1350,0,0,0,0,0,0,2,NA,2,0,0,0,0,0,9,0
"2372","Rocco Reitz",3,0,0,0,0,0,0,0,NA,0,0,0,0,0,0,0,0
"2373","Rochinha",18,0,0,0,0,0,0,0,NA,0,0,0,0,0,0,0,0
"2374","Rodri",1694,41,25,19,18,4,19,28,NA,9,24,9,15,21,62,22,0
"2375","Rodrigo",1582,15,8,2,8,5,7,14,NA,7,10,2,8,8,23,13,1
"2376","Rodrigo Battaglia",592,11,4,6,5,0,6,11,NA,5,12,7,5,5,16,16,0
"2377","Rodrigo Becão",782,27,14,19,8,0,15,17,NA,2,10,5,5,4,31,17,0
"2378","Rodrigo Bentancur",1865,53,33,19,26,8,22,33,NA,11,28,15,13,29,82,23,0
"2379","Rodrigo Conceição",5,1,1,1,0,0,1,1,NA,0,0,0,0,0,1,1,0
"2380","Rodrigo De Paul",1196,16,6,4,10,2,7,13,NA,6,23,2,21,9,25,4,0
"2381","Rodrigo Ely",1233,9,7,7,2,0,6,9,NA,3,18,15,3,16,25,81,0
"2382","Rodrigo Pinho",15,0,0,0,0,0,0,1,NA,1,0,0,0,0,0,1,0
"2383","Rodrigo Riquelme",796,7,0,4,1,2,3,12,NA,9,5,0,5,3,10,1,0
"2384","Rodrigo Zalazar",377,5,2,2,3,0,4,11,NA,7,4,1,3,1,6,6,0
"2385","Rodrygo",1393,16,8,3,9,4,3,8,NA,5,17,2,15,6,22,4,0
"2386","Rogelio Funes Mori",5,1,0,0,1,0,0,0,NA,0,0,0,0,0,1,0,0
"2387","Roger Ibanez",1170,34,17,16,17,1,13,18,NA,5,13,5,8,30,64,43,0
"2388","Roger Martí",430,3,1,1,2,0,0,3,NA,3,3,0,3,1,4,4,0
"2389","Rogério",1083,13,7,7,2,4,7,15,NA,8,12,3,9,12,25,24,0
"2390","Roko Simic",18,0,0,0,0,0,0,0,NA,0,0,0,0,0,0,0,0
"2391","Roland Sallai",376,4,4,1,3,0,2,6,NA,4,4,0,4,1,5,1,0
"2392","Rolando Mandragora",787,19,11,4,12,3,11,18,NA,7,6,1,5,8,27,12,0
"2393","Romain Del Castillo",514,17,12,6,7,4,5,10,NA,5,4,1,3,3,20,2,0
"2394","Romain Faivre",262,6,3,2,2,2,1,3,NA,2,2,0,2,0,6,0,0
"2395","Romain Hamouma",589,4,2,2,1,1,1,3,NA,2,2,0,2,1,5,0,0
"2396","Romain Perraud",851,25,14,9,12,4,13,18,NA,5,7,2,5,14,39,16,0
"2397","Romain Saïss",180,4,1,2,1,1,1,3,50,2,0,0,0,2,6,15,0
"2398","Roman Yaremchuk",51,1,1,0,0,1,0,0,NA,0,0,0,0,0,1,0,0
"2399","Romano Schmid",932,18,13,4,10,4,7,14,NA,7,17,3,14,5,23,9,0
"2400","Romario Ibarra",68,0,0,0,0,0,0,0,NA,0,1,0,1,1,1,2,0
"2401","Romelu Lukaku",266,0,0,0,0,0,0,0,NA,0,0,0,0,0,0,1,0
"2402","Roméo Lavia",557,11,7,6,5,0,4,10,NA,6,16,3,13,12,23,3,0
"2403","Rominigue Kouamé",1236,20,14,14,4,2,8,14,NA,6,16,5,11,26,46,15,0
"2404","Ronaël Pierre-Gabriel",635,24,18,11,11,2,14,16,NA,2,15,3,12,9,33,22,0
"2405","Ronald Araújo",600,9,7,5,4,0,2,3,NA,1,3,1,2,7,16,11,0
"2406","Rónald Matarrita",9,0,0,0,0,0,0,0,NA,0,0,0,0,0,0,0,0
"2407","Ronaldo Vieira",506,NA,8,NA,NA,NA,NA,NA,NA,NA,NA,NA,NA,9,NA,NA,NA
"2408","Rony Lopes",638,5,2,2,3,0,2,11,NA,9,2,0,2,1,6,1,0
"2409","Roony Bardghji",98,0,0,0,0,0,0,0,NA,0,0,0,0,0,0,1,0
"2410","Roozbeh Cheshmi",58,0,0,0,0,0,0,0,NA,0,1,1,0,2,2,3,0
"2411","Roque Mesa",862,18,7,13,5,0,8,23,NA,15,9,0,9,7,25,13,0
"2412","Ross Barkley",390,7,4,3,1,3,3,5,NA,2,2,0,2,3,10,3,0
"2413","Ruan",45,2,2,2,0,0,2,2,NA,0,2,1,1,2,4,2,0
"2414","Rubén",244,9,6,4,3,2,8,8,NA,0,3,1,2,7,16,3,0
"2415","Ruben Aguilar",327,9,3,5,1,3,3,9,NA,6,0,0,0,8,17,11,0
"2416","Rubén Alcaraz",513,14,9,8,6,0,5,13,NA,8,6,0,6,4,18,6,0
"2417","Rubén Blanco",270,0,0,0,0,0,0,0,NA,0,0,0,0,0,0,0,0
"2418","Rúben Dias",1472,13,9,7,6,0,4,7,NA,3,15,4,11,16,29,41,0
"2419","Rubén García",425,7,1,5,1,1,3,8,NA,5,5,0,5,4,11,6,0
"2420","Ruben Loftus-Cheek",1141,18,8,6,11,1,7,16,NA,9,11,2,9,13,31,17,0
"2421","Rúben Neves",1404,42,19,18,15,9,17,38,NA,21,23,13,10,20,62,36,0
"2422","Rubén Peña",563,11,5,2,9,0,8,15,NA,7,6,3,3,8,19,14,0
"2423","Rubén Sobrino",799,11,5,3,5,3,2,4,NA,2,7,0,7,6,17,11,0
"2424","Ruben Vargas",628,7,2,3,2,2,2,6,NA,4,4,2,2,3,10,9,1
"2425","Rúben Vinagre",26,2,2,1,1,0,1,2,NA,1,0,0,0,0,2,1,0
"2426","Rubin Colwill",10,0,0,0,0,0,0,1,0,1,1,0,1,0,0,0,0
"2427","Rui Patrício",1170,1,1,1,0,0,1,1,NA,0,0,0,0,2,3,1,2
"2428","Rui Silva",1080,2,1,2,0,0,2,2,NA,0,0,0,0,0,2,7,1
"2429","Ruslan Malinovskyi",522,14,8,5,6,3,6,15,NA,9,7,1,6,4,18,1,0
"2430","Ryan Christie",718,17,13,4,13,0,7,21,NA,14,8,2,6,8,25,9,0
"2431","Ryan Fraser",313,2,2,0,0,2,2,5,NA,3,3,1,2,0,2,3,0
"2432","Ryan Fredericks",451,1,1,1,0,0,0,2,NA,2,6,1,5,0,1,20,0
"2433","Ryan Gravenberch",435,12,8,3,7,2,6,9,NA,3,4,2,2,5,17,6,0
"2434","Ryan Jack",191,4,3,2,2,0,2,2,NA,0,1,1,0,1,5,1,1
"2435","Ryan Kent",507,6,3,3,1,2,1,3,NA,2,4,0,4,1,7,0,0
"2436","Ryan Sessegnon",817,23,16,11,10,2,7,14,NA,7,9,1,8,7,30,21,2
"2437","Ryan Yates",1033,22,12,8,11,3,10,15,NA,5,18,8,10,5,27,29,0
"2438","Saad Al Sheeb",90,0,0,0,0,0,0,0,NA,0,0,0,0,0,0,0,0
"2439","Sacha Delaye",20,1,0,0,0,1,1,1,NA,0,0,0,0,0,1,0,0
"2440","Sada Thioub",421,10,5,5,4,1,4,8,NA,4,5,0,5,2,12,3,0
"2441","Sadegh Moharrami",498,10,4,6,2,2,3,8,NA,5,5,1,4,1,11,5,0
"2442","Sadio Mané",1399,15,9,3,5,7,4,9,NA,5,20,3,17,4,19,4,0
"2443","Saeid Ezatolahi",217,6,1,1,3,2,2,6,133.3,4,3,0,3,2,8,4,0
"2444","Sael Kumbedi",17,0,0,0,0,0,0,0,NA,0,0,0,0,0,0,0,0
"2445","Saïd Benrahma",751,8,3,5,1,2,2,4,NA,2,9,1,8,3,11,4,0
"2446","Saidy Janko",263,4,3,4,0,0,3,5,NA,2,5,1,4,2,6,9,0
"2447","Saîf-Eddine Khaoui",740,15,8,5,9,1,3,11,NA,8,7,0,7,11,26,2,0
"2448","Saleh Al-Shehri",223,3,1,0,1,2,0,1,NA,1,3,1,2,0,3,2,0
"2449","Salem Al-Dawsari",270,5,4,3,2,0,1,2,NA,1,1,0,1,1,6,2,0
"2450","Salih Özcan",1273,18,9,6,10,2,12,32,NA,20,16,1,15,24,42,11,1
"2451","Salis Abdul Samed",1528,23,11,8,13,2,14,23,NA,9,18,5,13,19,42,19,0
"2452","Salman Al-Faraj",44,1,0,0,1,0,0,1,0,1,2,0,2,0,1,0,0
"2453","Salomón Rondón",109,0,0,0,0,0,0,0,NA,0,1,1,0,0,0,0,0
"2454","Salvatore Molina",229,6,5,2,4,0,4,5,NA,1,4,2,2,1,7,2,0
"2455","Salvi",264,7,5,2,3,2,1,3,NA,2,0,0,0,2,9,0,0
"2456","Sam Adekugbe",36,0,0,0,0,0,0,0,NA,0,1,0,1,0,0,0,0
"2457","Sam Greenwood",188,6,3,2,4,0,2,8,NA,6,4,1,3,1,7,1,0
"2458","Sam Lammers",767,16,9,5,7,4,6,9,NA,3,4,1,3,2,18,7,0
"2459","Sam Surridge",136,3,0,0,2,1,0,2,NA,2,3,2,1,0,3,5,0
"2460","Saman Ghoddos",83,1,0,1,0,0,0,1,NA,1,1,0,1,0,1,1,0
"2461","Sami Al-Najei",45,0,0,0,0,0,0,0,NA,0,1,0,1,0,0,0,0
"2462","Samir Handanović",720,0,0,0,0,0,0,0,NA,0,0,0,0,0,0,2,0
"2463","Samu Castillejo",612,8,2,2,4,2,3,11,NA,8,12,2,10,3,11,0,0
"2464","Samu Costa",768,21,9,13,5,3,8,24,NA,16,10,4,6,13,34,15,1
"2465","Samuel",1215,23,16,7,14,2,6,15,NA,9,12,0,12,4,27,2,0
"2466","Samuel Chukwueze",538,6,2,1,1,4,3,5,NA,2,4,0,4,2,8,8,0
"2467","Samuel Di Carmine",28,0,0,0,0,0,0,0,NA,0,0,0,0,0,0,0,0
"2468","Samuel Edozie",159,2,2,0,1,1,0,1,NA,1,0,0,0,2,4,2,0
"2469","Samuel Gigot",965,9,5,4,3,2,3,6,NA,3,16,6,10,24,33,35,1
"2470","Samuel Iling-Junior",46,0,0,0,0,0,0,1,NA,1,0,0,0,1,1,1,0
"2471","Samuel Moutoussamy",742,20,13,9,8,3,5,17,NA,12,6,1,5,7,27,4,0
"2472","Samuel Oum Gouet",100,1,1,0,1,0,0,0,NA,0,0,0,0,0,1,3,0
"2473","Samuel Sáiz",193,2,2,0,2,0,1,2,NA,1,2,0,2,0,2,1,1
"2474","Samuel Umtiti",276,4,1,3,1,0,3,3,NA,0,4,2,2,3,7,11,0
"2475","Samuele Birindelli",550,14,8,10,2,2,10,13,NA,3,12,4,8,9,23,11,0
"2476","Samuele Ricci",538,9,3,2,4,3,6,7,NA,1,8,2,6,4,13,8,0
"2477","Samuele Vignato",8,0,0,0,0,0,0,0,NA,0,0,0,0,0,0,0,0
"2478","Sandi Lovrić",768,13,7,3,7,3,8,15,NA,7,6,0,6,7,20,10,0
"2479","Sandro Tonali",1427,25,16,10,12,3,15,21,NA,6,14,7,7,13,38,7,1
"2480","Sanjin Prcić",788,14,5,3,10,1,10,12,NA,2,9,3,6,12,26,6,0
"2481","Sanoussy Ba",1,0,0,0,0,0,0,0,NA,0,0,0,0,0,0,0,0
"2482","Santi Comesaña",728,25,14,10,15,0,16,30,NA,14,11,1,10,11,36,3,0
"2483","Santiago Arzamendia",255,3,2,2,1,0,3,8,NA,5,7,0,7,0,3,6,1
"2484","Santiago Ascacíbar",699,27,12,16,9,2,14,29,NA,15,13,2,11,13,40,11,0
"2485","Santiago Bueno",1260,25,13,14,11,0,12,14,NA,2,16,12,4,19,44,30,0
"2486","Sardar Azmoun",414,4,2,1,2,1,1,4,NA,3,2,0,2,1,5,3,0
"2487","Sargis Adamyan",434,8,5,3,1,4,4,9,NA,5,7,0,7,1,9,2,0
"2488","Sasa Kalajdzic",278,3,2,0,1,2,1,3,NA,2,1,0,1,1,4,0,0
"2489","Saša Lukić",900,17,11,8,8,1,7,12,NA,5,13,5,8,8,25,13,1
"2490","Saud Abdulhamid",270,5,2,2,2,1,2,2,NA,0,3,0,3,2,7,6,0
"2491","Saúl Ñíguez",746,34,21,12,16,6,17,26,NA,9,19,1,18,12,46,17,0
"2492","Scott Arfield",267,4,1,0,4,0,1,6,NA,5,4,1,3,1,5,1,0
"2493","Scott McKenna",1260,11,6,7,2,2,5,8,NA,3,17,12,5,10,21,68,1
"2494","Scott McTominay",640,15,12,6,6,3,5,9,NA,4,5,2,3,9,24,25,0
"2495","Scott Wright",136,3,1,1,1,1,1,2,NA,1,0,0,0,1,4,2,0
"2496","Sead Haksabanović",229,5,3,2,0,3,5,5,NA,0,2,0,2,2,7,1,0
"2497","Sead Kolašinac",644,18,13,11,6,1,9,11,NA,2,9,1,8,15,33,10,0
"2498","Séamus Coleman",605,12,10,5,7,0,5,8,NA,3,7,3,4,9,21,17,1
"2499","Sean Goldberg",540,10,6,7,3,0,4,6,NA,2,6,4,2,4,14,24,0
"2500","Sean Longstaff",1056,17,10,5,7,5,8,23,NA,15,20,5,15,7,24,9,0
"2501","Sebastiaan Bornauw",725,5,3,4,1,0,3,7,NA,4,11,6,5,11,16,30,0
"2502","Sebastián Coates",484,9,3,6,3,0,5,6,NA,1,7,3,4,6,15,21,1
"2503","Sebastian Polter",465,4,3,0,4,0,1,3,NA,2,3,0,3,0,4,6,0
"2504","Sebastian Rode",824,22,14,8,13,1,6,17,NA,11,8,1,7,8,30,9,0
"2505","Sebastian Rudy",248,10,6,5,5,0,5,10,NA,5,8,1,7,2,12,8,0
"2506","Sebastian Szymański",71,3,1,1,1,1,0,1,0,1,3,1,2,1,4,1,0
"2507","Sebastian Walukiewicz",148,2,1,1,1,0,0,0,NA,0,3,3,0,0,2,7,0
"2508","Sebastiano Luperto",921,7,5,6,1,0,2,3,NA,1,16,13,3,16,23,47,0
"2509","Sébastien Corchia",371,7,3,4,0,3,5,10,NA,5,4,1,3,4,11,12,0
"2510","Sehrou Guirassy",801,2,1,1,1,0,1,1,NA,0,5,1,4,0,2,7,0
"2511","Seko Fofana",1113,11,6,4,6,1,5,15,NA,10,8,2,6,10,21,5,0
"2512","Sékou Gassama",36,0,0,0,0,0,0,0,NA,0,0,0,0,0,0,0,0
"2513","Sekou Koita",20,0,0,0,0,0,0,0,NA,0,0,0,0,0,0,0,0
"2514","Sekou Mara",214,5,2,0,4,1,2,5,NA,3,2,0,2,0,5,2,0
"2515","Selim Amallah",156,5,3,1,3,1,3,5,116.7,2,3,0,3,3,8,0,0
"2516","Sepe Elye Wahi",1168,5,3,2,2,1,2,4,NA,2,5,2,3,3,8,4,0
"2517","Sepp van den Berg",322,2,1,1,1,0,0,0,NA,0,4,2,2,8,10,19,1
"2518","Serge Aurier",530,23,13,17,4,2,7,8,NA,1,8,3,5,6,29,23,0
"2519","Serge Gnabry",1248,16,7,4,7,5,7,20,NA,13,16,1,15,7,23,6,1
"2520","Sergej Milinković-Savić",1204,26,10,10,12,4,14,28,NA,14,20,6,14,12,38,22,0
"2521","Sergi Canós",74,0,0,0,0,0,0,2,NA,2,3,1,2,0,0,1,0
"2522","Sergi Darder",1233,26,13,5,12,9,10,16,NA,6,8,0,8,13,39,8,0
"2523","Sergi Gómez",895,11,5,8,3,0,8,9,NA,1,8,5,3,12,23,56,0
"2524","Sergi Guardiola",377,11,6,6,4,1,2,4,NA,2,3,0,3,2,13,6,0
"2525","Sergi Roberto",583,10,6,5,4,1,6,8,NA,2,4,1,3,11,21,8,0
"2526","Sergiño Dest",566,12,4,4,3,5,6,10,NA,4,6,1,5,3,15,7,0
"2527","Sergio Akieme",1260,24,13,16,6,2,11,14,NA,3,14,3,11,9,33,24,0
"2528","Sergio Asenjo",450,0,0,0,0,0,0,0,NA,0,0,0,0,0,0,6,2
"2529","Sergio Busquets",1348,33,23,8,19,6,13,22,NA,9,18,4,14,17,50,14,3
"2530","Sergio Camello",934,8,5,2,4,2,2,6,NA,4,4,0,4,0,8,7,0
"2531","Sergio Canales",856,7,4,5,1,1,5,9,NA,4,5,0,5,2,9,4,0
"2532","Sergio Escudero",709,22,15,15,7,0,9,21,506.7,12,14,2,12,10,32,23,0
"2533","Sergio Gómez",389,6,2,3,2,1,2,3,NA,1,8,2,6,4,10,6,0
"2534","Sergio Herrera",900,0,0,0,0,0,0,0,NA,0,1,0,1,1,1,5,0
"2535","Sergio León",625,2,2,0,1,1,1,1,NA,0,4,0,4,0,2,3,0
"2536","Sergio Ramos",1548,19,14,7,10,2,14,24,NA,10,19,9,10,22,41,35,1
"2537","Sergio Reguilón",22,2,1,1,1,0,2,2,100,0,1,0,1,0,2,0,0
"2538","Sergio Rochet",180,0,0,0,0,0,0,0,NA,0,0,0,0,0,0,1,1
"2539","Serhiy Kryvtsov",6,0,0,0,0,0,0,0,NA,0,0,0,0,0,0,0,0
"2540","Shandon Baptiste",431,7,5,3,3,1,5,10,NA,5,4,1,3,5,12,7,0
"2541","Shane Duffy",6,0,0,0,0,0,0,0,NA,0,0,0,0,0,0,0,0
"2542","Shaquell Moore",22,2,2,1,1,0,2,2,NA,0,0,0,0,0,2,3,0
"2543","Sheraldo Becker",1051,3,1,0,2,1,0,1,NA,1,4,0,4,0,3,2,0
"2544","Shon Weissman",561,1,1,1,0,0,0,2,NA,2,7,0,7,1,2,6,0
"2545","Shūichi Gonda",180,0,0,0,0,0,0,0,NA,0,0,0,0,0,0,1,1
"2546","Sidi Sané",25,1,1,1,0,0,1,1,100,0,0,0,0,0,1,0,0
"2547","Silas Katompa",1043,16,12,4,8,4,5,11,NA,6,7,1,6,3,19,1,0
"2548","Silvan Widmer",1100,21,12,14,6,1,16,19,NA,3,15,4,11,20,41,26,0
"2549","Silvère Ganvoula M'Boussy",153,2,2,0,1,1,0,0,NA,0,0,0,0,0,2,3,0
"2550","Simon Kjær",685,5,3,4,1,0,2,4,NA,2,7,4,3,12,17,21,0
"2551","Simon Mignolet",540,0,0,0,0,0,0,0,NA,0,0,0,0,1,1,5,0
"2552","Simon Terodde",1052,10,6,3,4,3,1,8,NA,7,6,2,4,5,15,5,0
"2553","Simon Zoller",978,5,1,2,3,0,1,5,NA,4,7,0,7,4,9,13,0
"2554","Simone Bastoni",804,34,18,14,15,5,8,18,NA,10,15,4,11,7,41,8,0
"2555","Simone Verdi",415,7,3,2,3,2,3,4,NA,1,3,0,3,0,7,0,0
"2556","Sinaly Diomande",365,11,5,7,4,0,8,10,NA,2,5,4,1,9,20,19,1
"2557","Siriki Dembélé",8,1,0,1,0,0,0,1,0,1,0,0,0,1,2,0,0
"2558","Sofiane Boufal",852,13,6,6,5,2,4,12,NA,8,8,0,8,4,17,1,0
"2559","Sofiane Diop",518,8,6,4,3,1,0,6,NA,6,7,1,6,5,13,3,0
"2560","Sofyan Amrabat",969,18,11,9,4,5,7,13,NA,6,12,4,8,13,31,8,1
"2561","Solly March",1214,19,9,6,6,7,1,12,NA,11,15,2,13,13,32,20,0
"2562","Son Heung-min",1658,21,9,8,8,5,6,15,NA,9,10,1,9,6,27,6,0
"2563","Son Jun-ho",17,0,0,0,0,0,0,0,NA,0,0,0,0,1,1,0,0
"2564","Sorba Thomas",1,1,1,1,0,0,0,0,NA,0,0,0,0,0,1,0,0
"2565","Sotiris Alexandropoulos",121,1,1,0,1,0,0,0,NA,0,2,2,0,0,1,2,0
"2566","Soualiho Meïté",610,15,10,10,3,2,10,18,NA,8,9,2,7,6,21,9,0
"2567","Souleyman Doumbia",1075,24,16,14,9,1,7,15,NA,8,15,2,13,15,39,21,0
"2568","Souleymane Cissé",3,0,0,0,0,0,0,0,NA,0,0,0,0,0,0,2,0
"2569","Souleymane Touré",68,2,1,1,1,0,1,2,NA,1,1,0,1,0,2,5,0
"2570","Soumaïla Coulibaly",19,0,0,0,0,0,0,0,NA,0,0,0,0,1,1,1,0
"2571","Soungoutou Magassa",74,3,1,2,1,0,1,2,50,1,2,0,2,1,4,1,0
"2572","Srđan Babić",1138,12,6,9,3,0,6,13,NA,7,7,6,1,7,19,32,0
"2573","Stanislav Lobotka",1545,43,24,20,17,6,23,33,NA,10,16,4,12,7,50,7,1
"2574","Stanley N'Soki",642,5,4,3,2,0,2,6,NA,4,16,4,12,12,17,18,0
"2575","Stefan Bajcetic",46,2,2,1,1,0,2,2,NA,0,0,0,0,0,2,0,0
"2576","Stefan Bell",893,14,10,12,2,0,8,15,NA,7,15,3,12,23,37,35,0
"2577","Stefan de Vrij",1165,20,10,16,4,0,7,9,NA,2,9,7,2,24,44,52,0
"2578","Stefan Lainer",30,1,0,0,0,1,0,0,NA,0,0,0,0,0,1,1,0
"2579","Stefan Mitrović",1070,5,3,4,1,0,2,7,NA,5,6,6,0,10,15,64,2
"2580","Stefan Ortega",180,0,0,0,0,0,0,0,NA,0,0,0,0,0,0,0,1
"2581","Stefan Posch",544,16,11,11,4,1,9,13,NA,4,7,3,4,10,26,16,0
"2582","Stefan Ristovski",370,6,2,4,1,1,2,6,NA,4,7,4,3,6,12,8,0
"2583","Stefan Savić",1155,19,14,16,2,1,15,18,NA,3,6,2,4,18,37,37,0
"2584","Stefano Sensi",782,28,19,17,9,2,13,25,NA,12,9,1,8,11,39,3,0
"2585","Steffen Tigges",720,5,3,1,3,1,3,6,NA,3,5,0,5,3,8,10,0
"2586","Stephan El Shaarawy",272,2,1,1,1,0,0,2,NA,2,2,0,2,5,7,4,0
"2587","Stéphane Diarra",616,11,9,5,4,2,6,16,NA,10,7,0,7,13,24,5,0
"2588","Stephen Eustáquio",650,18,9,10,8,0,6,17,NA,11,6,1,5,13,31,15,0
"2589","Stephen Welsh",90,0,0,0,0,0,0,0,NA,0,1,1,0,1,1,6,0
"2590","Stephy Mavididi",335,3,2,1,0,2,2,5,NA,3,7,0,7,0,3,2,0
"2591","Stevan Jovetić",398,1,1,0,1,0,0,1,NA,1,0,0,0,0,1,4,0
"2592","Steve Cook",957,8,4,4,4,0,5,6,NA,1,16,11,5,12,20,51,0
"2593","Steve Mandanda",1215,0,0,0,0,0,0,0,NA,0,0,0,0,0,0,1,2
"2594","Steve Mounié",45,0,0,0,0,0,0,0,NA,0,0,0,0,1,1,0,0
"2595","Steven Berghuis",587,15,10,3,8,4,8,12,NA,4,6,0,6,4,19,0,0
"2596","Steven Bergwijn",642,4,2,1,1,2,1,1,NA,0,2,0,2,1,5,1,0
"2597","Steven Davis",249,5,4,2,2,1,1,1,NA,0,4,0,4,2,7,3,0
"2598","Steven Fortes",7,0,0,0,0,0,0,0,NA,0,0,0,0,0,0,0,0
"2599","Steven Vitória",180,2,2,1,1,0,2,2,NA,0,3,1,2,0,2,6,0
"2600","Stijn Spierings",1350,38,26,14,22,2,15,35,NA,20,22,5,17,14,52,20,0
"2601","Stole Dimitrievski",1170,0,0,0,0,0,0,0,NA,0,2,0,2,0,0,6,2
"2602","Strahinja Pavlović",685,22,10,15,7,0,9,12,NA,3,9,7,2,4,26,34,1
"2603","Stuart Armstrong",690,13,7,6,5,2,3,15,NA,12,9,0,9,3,16,5,0
"2604","Suat Serdar",967,30,14,8,17,5,10,21,NA,11,25,8,17,13,43,14,0
"2605","Suf Podgoreanu",12,0,0,0,0,0,0,0,NA,0,0,0,0,0,0,0,0
"2606","Suliman Mustapha",68,2,2,0,2,0,0,0,NA,0,4,0,4,0,2,0,0
"2607","Sultan Al-Ghanam",126,0,0,0,0,0,0,1,NA,1,3,1,2,2,2,3,0
"2608","Sun Menachem",59,3,3,3,0,0,2,3,NA,1,0,0,0,0,3,2,0
"2609","Suso",325,5,4,1,3,1,1,6,NA,5,3,1,2,1,6,1,0
"2610","Sven Botman",1057,14,9,11,3,0,8,10,NA,2,13,7,6,11,25,37,1
"2611","Sven Michel",229,2,1,1,0,1,2,2,NA,0,1,0,1,0,2,2,0
"2612","Sven Ulreich",540,1,1,1,0,0,1,1,NA,0,0,0,0,0,1,0,1
"2613","Szymon Żurkowski",32,0,0,0,0,0,0,0,NA,0,0,0,0,0,0,0,0
"2614","Taha Yassine Khenissi",29,0,0,0,0,0,0,0,NA,0,0,0,0,0,0,0,0
"2615","Taïryk Arconte",26,0,0,0,0,0,0,0,NA,0,0,0,0,0,0,0,0
"2616","Taiwo Awoniyi",512,5,4,0,4,1,2,3,NA,1,5,1,4,1,6,7,0
"2617","Tajon Buchanan",510,8,4,7,0,1,4,9,NA,5,4,0,4,1,9,2,0
"2618","Takefusa Kubo",887,17,8,6,6,5,4,11,NA,7,9,0,9,2,19,1,0
"2619","Takehiro Tomiyasu",455,13,9,6,4,3,7,8,NA,1,3,0,3,11,24,14,0
"2620","Takuma Asano",478,1,1,0,0,1,0,1,NA,1,5,1,4,3,4,1,0
"2621","Takumi Minamino",358,7,3,3,3,1,4,15,NA,11,11,0,11,4,11,4,0
"2622","Tammy Abraham",861,8,5,3,3,2,2,6,NA,4,4,2,2,1,9,4,0
"2623","Tanguy Coulibaly",24,3,2,2,1,0,1,1,100,0,1,0,1,0,3,0,0
"2624","Tanguy Ndombele",651,13,4,4,8,1,5,8,NA,3,7,1,6,6,19,4,1
"2625","Tanguy Nianzou",820,12,10,7,5,0,6,7,NA,1,6,4,2,10,22,23,0
"2626","Taras Stepanenko",532,18,11,12,5,1,10,28,177.7,18,2,1,1,12,30,21,1
"2627","Tarek Salman",8,1,0,1,0,0,0,0,NA,0,0,0,0,1,2,0,0
"2628","Tariq Lamptey",290,5,3,3,1,1,3,5,NA,2,3,1,2,4,9,6,0
"2629","Téji Savanier",1019,21,14,8,8,5,9,18,NA,9,10,2,8,11,32,5,1
"2630","Terem Moffi",1032,8,5,1,4,3,3,3,NA,0,9,2,7,1,9,7,0
"2631","Tetê",873,13,7,5,3,5,6,14,NA,8,6,0,6,9,22,1,0
"2632","Tete Morente",718,9,4,5,3,1,4,9,NA,5,9,1,8,4,13,9,0
"2633","Teun Koopmeiners",1314,26,16,7,16,3,15,27,NA,12,18,5,13,14,40,22,0
"2634","Theo Bongonda",446,5,4,1,3,1,1,5,NA,4,3,0,3,1,6,2,0
"2635","Theo Hernández",1547,34,22,21,11,2,16,23,NA,7,19,4,15,11,45,13,3
"2636","Théo Le Bris",815,18,13,9,7,2,9,21,NA,12,12,1,11,13,31,11,0
"2637","Théo Sainte-Luce",355,7,5,3,4,0,4,10,NA,6,4,2,2,4,11,5,0
"2638","Theo Walcott",113,2,1,1,0,1,1,1,NA,0,0,0,0,1,3,0,0
"2639","Thiago Alcántara",950,38,21,16,18,4,14,21,NA,7,11,1,10,16,54,5,1
"2640","Thiago Almada",7,0,0,0,0,0,0,0,NA,0,0,0,0,0,0,0,0
"2641","Thiago Mendes",1167,30,16,12,17,1,23,25,NA,2,12,6,6,31,61,36,3
"2642","Thiago Silva",1640,26,16,13,12,1,12,16,NA,4,28,20,8,25,51,70,2
"2643","Thibault De Smet",172,5,3,2,3,0,4,5,150,1,3,0,3,0,5,3,0
"2644","Thibaut Courtois",1440,0,0,0,0,0,0,1,NA,1,0,0,0,0,0,2,2
"2645","Thierno Balde",795,15,6,8,4,3,12,18,NA,6,5,2,3,10,25,14,0
"2646","Thierry Correia",1211,32,22,19,12,1,17,26,NA,9,13,1,12,16,48,32,2
"2647","Thijs Dallinga",900,3,3,0,1,2,0,3,NA,3,8,2,6,1,4,10,0
"2648","Thilo Kehrer",1239,28,14,16,9,3,17,31,NA,14,9,3,6,23,51,37,1
"2649","Thomas Cannon",17,0,0,0,0,0,0,0,NA,0,0,0,0,0,0,0,0
"2650","Thomas Delaine",709,15,8,10,2,3,8,14,NA,6,7,2,5,5,20,6,0
"2651","Thomas Delaney",583,7,5,0,7,0,4,8,NA,4,5,3,2,5,12,9,0
"2652","Thomas Foket",13,1,1,1,0,0,1,1,100,0,0,0,0,2,3,0,0
"2653","Thomas Henry",857,5,3,1,1,3,1,3,NA,2,5,2,3,0,5,11,0
"2654","Thomas Kastanaras",5,0,0,0,0,0,0,0,NA,0,0,0,0,0,0,0,0
"2655","Thomas Lemar",494,9,4,2,4,3,2,8,NA,6,5,2,3,4,13,3,0
"2656","Thomas Mangani",520,8,6,3,3,2,4,13,NA,9,7,1,6,11,19,5,0
"2657","Thomas Meunier",1041,30,16,16,10,4,18,27,NA,9,14,3,11,17,47,27,0
"2658","Thomas Müller",957,5,5,2,1,2,3,9,NA,6,10,2,8,4,9,6,0
"2659","Thomas Ouwejan",739,18,7,12,5,1,6,10,NA,4,16,3,13,12,30,21,0
"2660","Thomas Partey",1139,30,17,15,11,4,12,21,NA,9,10,3,7,14,44,25,1
"2661","Thorgan Hazard",738,22,9,7,13,2,15,24,NA,9,11,1,10,8,30,8,0
"2662","Þórir Jóhann Helgason",150,1,1,0,0,1,1,1,NA,0,1,0,1,2,3,2,0
"2663","Tiago Djaló",1060,16,12,13,2,1,8,11,NA,3,11,6,5,13,29,34,1
"2664","Tiago Tomás",723,7,4,2,3,2,5,6,NA,1,8,2,6,0,7,2,0
"2665","Tim Lemperle",35,0,0,0,0,0,0,0,NA,0,1,0,1,0,0,1,0
"2666","Tim Oermann",194,2,1,2,0,0,1,1,NA,0,3,2,1,1,3,8,1
"2667","Tim Ream",1617,18,10,9,6,3,6,13,NA,7,25,16,9,24,42,60,0
"2668","Tim Skarke",53,1,1,0,0,1,0,0,NA,0,1,0,1,0,1,0,0
"2669","Timo Baumgartl",314,9,5,5,2,2,4,13,NA,9,6,2,4,1,10,4,0
"2670","Timo Hübers",1029,20,12,16,4,0,9,16,NA,7,6,4,2,23,43,64,0
"2671","Timo Werner",995,3,2,1,2,0,0,5,NA,5,5,0,5,1,4,3,1
"2672","Timothée Kolodziejczak",25,0,0,0,0,0,0,1,0,1,0,0,0,1,1,1,0
"2673","Timothy Castagne",1371,33,20,25,5,3,14,28,NA,14,17,5,12,16,49,36,0
"2674","Timothy Chandler",91,2,2,2,0,0,2,2,NA,0,1,0,1,0,2,3,0
"2675","Timothy Fosu-Mensah",123,5,4,2,2,1,1,1,NA,0,1,0,1,1,6,1,0
"2676","Timothy Weah",567,3,3,1,2,0,3,5,NA,2,11,0,11,3,6,1,0
"2677","Tjaronn Chery",540,2,1,0,2,0,0,3,NA,3,5,0,5,1,3,2,0
"2678","Tobias Mohr",695,7,4,3,4,0,2,7,NA,5,12,5,7,8,15,19,0
"2679","Tobias Sippel",270,0,0,0,0,0,0,0,NA,0,0,0,0,0,0,1,1
"2680","Toby Alderweireld",180,2,0,2,0,0,1,2,100,1,1,1,0,0,2,14,0
"2681","Tolgay Arslan",446,10,7,5,5,0,3,8,NA,5,4,0,4,5,15,6,0
"2682","Tom Bischof",15,0,0,0,0,0,0,0,NA,0,1,0,1,0,0,0,0
"2683","Tom Cairney",343,7,2,1,4,2,4,4,NA,0,7,1,6,1,8,0,0
"2684","Tom Davies",298,8,5,4,4,0,3,5,NA,2,3,0,3,3,11,6,1
"2685","Tom Krauß",1232,64,36,25,34,5,24,46,NA,22,26,4,22,16,80,13,0
"2686","Tom Rothe",75,1,1,0,1,0,1,1,NA,0,4,1,3,1,2,4,0
"2687","Toma Bašić",216,1,0,0,0,1,1,3,NA,2,2,0,2,2,3,2,0
"2688","Tomás Alarcón",223,3,2,0,2,1,1,2,NA,1,1,0,1,2,5,2,0
"2689","Tomáš Chorý",361,3,1,0,0,3,1,3,NA,2,4,0,4,1,4,6,0
"2690","Tomáš Koubek",360,0,0,0,0,0,0,0,NA,0,0,0,0,0,0,2,0
"2691","Tomás Rincón",1090,27,13,6,16,5,13,21,NA,8,14,0,14,16,43,4,0
"2692","Tomáš Souček",1307,47,25,28,19,0,17,33,783.4,16,21,8,13,24,71,26,1
"2693","Tommaso Augello",1016,5,4,4,1,0,2,5,NA,3,6,3,3,5,10,18,1
"2694","Tommaso Baldanzi",216,4,4,1,3,0,2,3,NA,1,0,0,0,0,4,1,0
"2695","Tommaso Barbieri",3,2,1,0,2,0,1,1,100,0,0,0,0,0,2,0,0
"2696","Tommaso Milanese",11,0,0,0,0,0,0,0,NA,0,0,0,0,0,0,0,0
"2697","Tommaso Pobega",505,16,8,3,11,2,6,13,NA,7,7,2,5,5,21,3,0
"2698","Toni Kroos",1303,33,20,7,25,1,13,29,NA,16,19,3,16,11,44,6,0
"2699","Toni Lato",276,5,1,2,3,0,1,3,NA,2,2,0,2,2,7,8,0
"2700","Toni Martínez",93,7,4,1,4,2,2,2,NA,0,1,0,1,0,7,0,0
"2701","Toni Villa",380,15,9,7,6,2,7,14,NA,7,3,0,3,3,18,1,0
"2702","Tonny Vilhena",953,22,12,4,16,2,10,18,NA,8,8,2,6,6,28,8,0
"2703","Tony Jantschke",87,2,1,1,1,0,1,1,NA,0,3,2,1,0,2,4,0
"2704","Tosin Adarabioyo",900,11,4,9,2,0,4,6,NA,2,7,6,1,11,22,50,0
"2705","Toti Gomes",259,3,2,3,0,0,2,2,NA,0,3,2,1,1,4,19,0
"2706","Trent Alexander-Arnold",1468,31,23,21,7,3,24,40,NA,16,13,3,10,15,46,16,0
"2707","Trevoh Chalobah",1043,16,12,13,2,1,10,19,NA,9,6,4,2,12,28,37,0
"2708","Tristan Dingomé",87,1,1,0,1,0,0,2,NA,2,0,0,0,0,1,0,0
"2709","Tuta",1760,38,24,21,13,4,21,41,NA,20,27,6,21,29,67,90,1
"2710","Tyler Adams",1436,62,37,35,23,4,33,49,NA,16,25,4,21,19,81,18,0
"2711","Tymoteusz Puchacz",58,1,0,1,0,0,0,0,NA,0,0,0,0,0,1,1,0
"2712","Tyrell Malacia",567,15,11,13,1,1,4,12,NA,8,7,2,5,8,23,18,0
"2713","Tyrese Francois",1,0,0,0,0,0,0,0,NA,0,0,0,0,0,0,1,0
"2714","Tyrick Mitchell",977,18,11,13,4,1,7,16,NA,9,15,4,11,8,26,27,0
"2715","Tyrone Mings",1170,7,2,4,3,0,4,5,NA,1,14,10,4,18,25,63,1
"2716","Tyronne Ebuehi",313,0,0,0,0,0,0,0,NA,0,6,5,1,2,2,16,0
"2717","Umar Sadiq",322,1,1,0,0,1,0,2,NA,2,4,0,4,0,1,3,0
"2718","Unai García",1116,12,7,8,2,2,7,10,NA,3,17,11,6,16,28,43,0
"2719","Unai López",554,7,4,2,3,2,3,9,NA,6,4,1,3,7,14,3,1
"2720","Unai Núñez",1170,10,7,4,5,1,2,9,NA,7,7,5,2,23,33,49,1
"2721","Unai Simón",1440,0,0,0,0,0,0,0,NA,0,1,0,1,0,0,8,3
"2722","Unai Vencedor Paris",141,3,1,0,3,0,1,5,NA,4,3,0,3,1,4,0,0
"2723","Uriel Antuna",77,4,3,1,2,1,2,2,NA,0,1,0,1,0,4,0,0
"2724","Václav Jemelka",361,12,7,9,2,1,4,10,NA,6,7,3,4,5,17,12,0
"2725","Václav Pilař",123,2,1,0,1,1,1,3,NA,2,0,0,0,0,2,1,0
"2726","Valdemar Jensen",304,5,5,4,1,0,3,5,NA,2,5,4,1,5,10,5,0
"2727","Valentin Antov",144,5,4,3,2,0,1,3,NA,2,4,3,1,0,5,1,1
"2728","Valentin Carboni",18,0,0,0,0,0,0,1,NA,1,1,0,1,0,0,0,0
"2729","Valentín Castellanos",1112,6,3,1,2,3,0,7,NA,7,11,2,9,4,10,9,0
"2730","Valentin Gendrey",1094,33,18,24,7,2,14,24,NA,10,15,2,13,15,48,36,0
"2731","Valentin Rongier",1557,40,23,17,19,4,14,27,NA,13,22,5,17,27,67,19,0
"2732","Valentino Lazaro",750,9,5,6,0,3,5,7,NA,2,8,1,7,1,10,11,0
"2733","Valère Germain",290,3,3,0,1,2,2,4,NA,2,3,0,3,2,5,6,0
"2734","Valerii Bondar",540,7,5,5,2,0,2,3,NA,1,11,9,2,7,14,30,1
"2735","Valerio Verre",432,11,5,4,5,2,6,10,NA,4,6,1,5,8,19,2,0
"2736","Valery",398,6,3,1,5,0,2,3,NA,1,3,0,3,2,8,2,0
"2737","Vanderson",854,29,17,12,15,2,17,24,NA,7,19,4,15,26,55,16,1
"2738","Vanja Milinković-Savić",1350,0,0,0,0,0,0,0,NA,0,0,0,0,2,2,5,1
"2739","Vassilis Lambropoulos",477,7,6,5,2,0,3,4,NA,1,4,3,1,10,17,30,0
"2740","Vedat Muriqi",1037,6,4,3,3,0,2,4,NA,2,5,2,3,3,9,19,0
"2741","Veljko Birmančević",172,5,3,2,2,1,4,8,NA,4,8,2,6,1,6,0,0
"2742","Vicente Guaita",1260,0,0,0,0,0,0,0,NA,0,0,0,0,0,0,6,0
"2743","Victor Bernth Kristiansen",483,15,6,9,3,3,5,7,NA,2,11,1,10,6,21,14,0
"2744","Víctor Chust",851,8,6,7,1,0,3,6,NA,3,7,3,4,10,18,44,0
"2745","Victor Lindelöf",352,5,3,3,2,0,2,2,NA,0,4,2,2,4,9,18,0
"2746","Victor Nelsson",90,0,0,0,0,0,0,1,0,1,2,1,1,2,2,1,0
"2747","Victor Osimhen",905,5,2,0,2,3,4,9,NA,5,3,1,2,2,7,10,0
"2748","Víctor Ruiz",341,1,0,1,0,0,0,0,NA,0,6,3,3,3,4,18,0
"2749","Viktor Claesson",482,9,8,7,1,1,4,6,NA,2,4,2,2,9,18,8,0
"2750","Viktor Kovalenko",324,7,3,0,5,2,3,3,NA,0,7,2,5,0,7,3,0
"2751","Vincent Aboubakar",53,0,0,0,0,0,0,0,NA,0,0,0,0,0,0,0,0
"2752","Vincent Janssen",86,2,0,0,1,1,0,1,NA,1,2,0,2,0,2,1,0
"2753","Vincent Le Goff",1350,34,19,25,8,1,24,27,1200,3,10,2,8,17,51,44,1
"2754","Vincent Marchetti",1201,31,18,16,11,4,15,33,NA,18,11,1,10,10,41,11,0
"2755","Vincenzo Grifo",1120,7,3,2,4,1,2,10,NA,8,3,0,3,8,15,6,0
"2756","Vinicius Júnior",1831,25,16,11,9,5,9,20,NA,11,17,1,16,5,30,2,0
"2757","Vinicius Souza",1188,53,34,21,23,9,16,26,NA,10,14,9,5,29,82,27,1
"2758","Virgil van Dijk",2070,14,5,9,5,0,3,8,NA,5,20,14,6,20,34,86,1
"2759","Vitaliy Mykolenko",1283,23,11,15,8,0,8,14,NA,6,28,9,19,23,46,42,0
"2760","Vitaly Janelt",990,25,13,9,11,5,11,18,NA,7,9,4,5,14,39,14,0
"2761","Vitinha",1325,25,13,10,10,5,11,35,NA,24,11,1,10,20,45,8,0
"2762","Vito Mannone",168,0,0,0,0,0,0,0,NA,0,0,0,0,0,0,2,0
"2763","Vlad Chiricheș",342,18,9,14,3,1,6,7,NA,1,12,6,6,13,31,9,0
"2764","Vladimír Coufal",685,14,9,12,2,0,9,14,NA,5,9,2,7,15,29,14,0
"2765","Vladimír Darida",31,1,1,0,1,0,0,0,NA,0,1,0,1,0,1,0,0
"2766","Wahbi Khazri",790,14,7,6,8,0,4,12,NA,8,5,1,4,6,20,7,0
"2767","Wajdi Kechrida",111,3,3,3,0,0,1,1,NA,0,2,1,1,0,3,4,0
"2768","Walace",1191,37,20,19,15,3,16,33,NA,17,21,5,16,18,55,17,0
"2769","Waldemar Anton",1344,26,16,14,11,1,9,16,NA,7,21,10,11,20,46,61,2
"2770","Walker Zimmerman",189,1,0,1,0,0,1,2,NA,1,2,2,0,1,2,11,0
"2771","Waniss Taibi",137,6,3,3,2,1,2,3,NA,1,0,0,0,2,8,1,0
"2772","Warren Bondo",32,0,0,0,0,0,0,0,NA,0,0,0,0,0,0,0,0
"2773","Warren Zaire-Emery",39,1,1,1,0,0,1,3,NA,2,0,0,0,1,2,0,0
"2774","Wassim Boullif",69,2,1,2,0,0,2,2,NA,0,3,2,1,0,2,1,0
"2775","Wataru Endo",1392,42,23,20,19,3,20,37,NA,17,20,7,13,15,57,41,0
"2776","Wayne Hennessey",175,0,0,0,0,0,0,0,NA,0,0,0,0,0,0,0,0
"2777","Wendell",129,3,1,2,1,0,1,3,NA,2,2,0,2,1,4,2,0
"2778","Wesley Fofana",487,13,7,4,7,2,6,11,NA,5,4,1,3,15,28,11,0
"2779","Wesley Saïd",400,2,0,1,0,1,0,2,NA,2,4,0,4,1,3,1,0
"2780","Weston McKennie",1281,15,7,5,7,3,9,16,NA,7,24,4,20,10,25,17,0
"2781","Wilfred Ndidi",638,16,12,10,6,0,7,14,NA,7,11,5,6,14,30,18,1
"2782","Wilfried Kanga",933,4,4,2,1,1,2,3,NA,1,11,3,8,0,4,10,0
"2783","Wilfried Singo",578,9,6,5,2,2,7,7,NA,0,5,0,5,2,11,14,0
"2784","Wilfried Zaha",1147,22,14,10,8,4,5,11,NA,6,10,0,10,6,28,4,0
"2785","Will Hughes",92,4,2,2,1,1,2,4,NA,2,1,1,0,0,4,1,0
"2786","Willi Orban",1890,35,23,22,11,2,21,31,NA,10,25,15,10,30,65,93,0
"2787","William Carvalho",1042,19,11,8,10,1,4,16,NA,12,10,4,6,5,24,10,0
"2788","William Clem",170,5,2,3,0,2,2,7,70,5,2,0,2,4,9,0,0
"2789","William Saliba",1273,22,12,14,6,2,11,13,NA,2,8,5,3,9,31,39,3
"2790","Willian",564,5,3,3,0,2,3,4,NA,1,5,0,5,3,8,2,0
"2791","Willian José",271,4,3,3,1,0,2,5,NA,3,2,0,2,0,4,5,0
"2792","Williot Swedberg",34,1,0,0,0,1,0,0,NA,0,0,0,0,0,1,0,0
"2793","Willy Boly",152,4,0,3,1,0,3,7,90,4,0,0,0,1,5,9,0
"2794","Wilson Odobert",698,8,8,5,2,1,4,11,NA,7,5,0,5,6,14,1,0
"2795","Wissam Ben Yedder",811,6,3,2,1,3,2,7,NA,5,10,0,10,3,9,0,0
"2796","Wladimiro Falcone",1260,1,0,1,0,0,1,1,NA,0,0,0,0,1,2,10,0
"2797","Wojciech Szczęsny",1302,1,0,1,0,0,0,1,NA,1,0,0,0,0,1,5,0
"2798","Wout Faes",1080,26,13,12,13,1,14,20,NA,6,18,11,7,16,42,51,0
"2799","Wout Weghorst",20,0,0,0,0,0,0,0,NA,0,0,0,0,0,0,0,0
"2800","Xaver Schlager",1330,27,16,9,16,2,15,31,NA,16,15,2,13,10,37,17,0
"2801","Xavier Chavalerin",723,21,12,11,7,3,12,24,NA,12,6,2,4,9,30,5,0
"2802","Xeka",434,9,3,5,3,1,6,14,242.9,8,9,2,7,3,12,8,0
"2803","Xherdan Shaqiri",71,0,0,0,0,0,0,0,NA,0,0,0,0,0,0,0,0
"2804","Yacine Adli",116,6,3,2,4,0,2,2,NA,0,2,0,2,1,7,1,0
"2805","Yahia Fofana",720,0,0,0,0,0,0,0,NA,0,0,0,0,1,1,1,1
"2806","Yahya Attiat Allah",54,0,0,0,0,0,0,0,NA,0,1,0,1,0,0,4,0
"2807","Yan Couto",506,13,9,8,3,2,6,10,NA,4,4,1,3,3,16,2,0
"2808","Yan Valery",712,11,9,6,5,0,3,6,NA,3,12,4,8,8,19,21,0
"2809","Yangel Herrera",629,19,7,7,10,2,4,8,NA,4,10,1,9,2,21,6,0
"2810","Yanis Begraoui",52,2,0,1,0,1,1,2,NA,1,0,0,0,1,3,0,0
"2811","Yanis Cimignani",279,11,5,3,7,1,4,5,NA,1,5,1,4,2,13,2,0
"2812","Yanis Massolin",38,1,1,0,0,1,0,0,NA,0,1,0,1,2,3,0,0
"2813","Yann Karamoh",24,3,1,2,1,0,1,1,NA,0,0,0,0,0,3,0,0
"2814","Yann Sommer",1080,1,0,1,0,0,1,1,NA,0,0,0,0,0,1,8,0
"2815","Yannick Carrasco",1058,24,16,15,9,0,20,36,NA,16,13,1,12,5,29,11,0
"2816","Yannick Gerhardt",700,10,5,5,1,4,4,10,NA,6,9,2,7,3,13,7,0
"2817","Yannik Keitel",347,5,4,2,3,0,2,2,NA,0,2,0,2,8,13,0,0
"2818","Yasser Al-Shahrani",89,3,1,0,3,0,1,1,100,0,0,0,0,6,9,6,0
"2819","Yasser Larouci",747,9,5,6,2,1,5,7,NA,2,4,1,3,9,18,16,0
"2820","Yassine Bounou",1485,1,1,1,0,0,1,4,NA,3,0,0,0,1,2,12,2
"2821","Yassine Meriah",270,4,2,3,0,1,3,8,120,5,5,0,5,1,5,20,0
"2822","Yayah Kallon",250,5,4,2,1,2,3,5,NA,2,5,0,5,3,8,0,0
"2823","Yehvann Diouf",720,0,0,0,0,0,0,0,NA,0,0,0,0,0,0,5,1
"2824","Yeltsin Tejeda",180,2,1,1,1,0,1,5,50,4,6,4,2,0,2,3,0
"2825","Yeray Álvarez",1056,15,10,12,2,1,11,13,NA,2,13,10,3,26,41,43,0
"2826","Yeremi Pino",697,19,13,11,6,2,8,19,NA,11,8,1,7,6,25,15,0
"2827","Yerry Mina",69,1,0,0,1,0,0,0,NA,0,2,1,1,1,2,3,0
"2828","Yıldırım Mert Çetin",20,1,0,1,0,0,0,0,NA,0,0,0,0,1,2,1,0
"2829","Yoane Wissa",642,12,8,2,6,4,6,6,NA,0,3,0,3,3,15,8,0
"2830","Yoann Cathline",236,5,3,2,1,2,0,1,NA,1,1,0,1,2,7,0,0
"2831","Yoann Salmier",1070,23,11,11,9,3,13,18,NA,5,16,9,7,20,43,29,0
"2832","Yoann Touzghar",243,2,2,0,2,0,0,1,NA,1,0,0,0,0,2,0,0
"2833","Yohann Magnin",941,32,21,14,15,3,15,33,NA,18,19,4,15,15,47,25,0
"2834","Youcef Atal",624,34,19,16,14,4,21,25,NA,4,6,0,6,11,45,11,0
"2835","Youcef Belaïli",676,14,6,3,6,5,5,13,NA,8,6,1,5,2,16,5,0
"2836","Youri Baas",44,2,0,1,1,0,0,1,NA,1,0,0,0,0,2,1,0
"2837","Youri Tielemans",1241,37,18,16,16,5,15,29,NA,14,23,5,18,13,50,10,0
"2838","Youssef En-Nesyri",759,6,4,0,3,3,3,8,NA,5,5,1,4,3,9,9,0
"2839","Youssef Maleh",297,3,1,0,3,0,0,4,NA,4,5,0,5,1,4,3,0
"2840","Youssef Msakni",169,3,1,1,2,0,0,1,NA,1,2,1,1,0,3,1,0
"2841","Youssouf Fofana",1251,38,15,12,22,4,19,27,NA,8,16,2,14,13,51,11,0
"2842","Youssouf Koné",462,19,12,16,3,0,10,14,NA,4,5,2,3,7,26,19,1
"2843","Youssouf M'Changama",298,5,2,3,2,0,0,3,NA,3,2,0,2,3,8,1,1
"2844","Youssouf Sabaly",900,18,10,14,3,1,11,12,NA,1,13,3,10,10,28,27,1
"2845","Youssoufa Moukoko",1012,14,7,4,6,4,3,5,NA,2,4,0,4,1,15,1,0
"2846","Youstin Salas",2,0,0,0,0,0,0,0,NA,0,1,0,1,0,0,0,0
"2847","Yukhym Konoplia",418,10,7,3,6,1,5,11,NA,6,8,1,7,2,12,12,1
"2848","Yuki Soma",81,2,0,0,2,0,0,1,0,1,0,0,0,0,2,0,0
"2849","Yunis Abdelhamid",1350,33,20,17,16,0,15,19,NA,4,30,12,18,34,67,43,0
"2850","Yunus Musah",1099,27,19,11,14,2,6,11,NA,5,11,0,11,6,33,10,2
"2851","Yuri Berchiche",440,9,6,6,2,1,7,13,NA,6,9,2,7,7,16,13,0
"2852","Yussuf Poulsen",166,2,0,0,2,0,1,2,NA,1,4,0,4,0,2,3,0
"2853","Yusuf Yazıcı",200,0,0,0,0,0,0,0,NA,0,2,0,2,0,0,1,0
"2854","Yuto Nagatomo",101,1,1,0,0,1,0,0,NA,0,0,0,0,0,1,1,0
"2855","Yvandro Borges Sanches",28,2,2,0,2,0,2,2,NA,0,0,0,0,0,2,0,0
"2856","Yves Bissouma",698,11,8,4,4,3,3,7,NA,4,15,5,10,10,21,7,0
"2857","Yvon Mvogo",1182,0,0,0,0,0,0,0,NA,0,0,0,0,2,2,3,2
"2858","Zaidu Sanusi",411,8,5,6,2,0,6,9,NA,3,3,1,2,6,14,11,0
"2859","Zakaria Aboukhlal",1188,12,9,5,4,3,4,16,NA,12,9,1,8,11,23,6,0
"2860","Zeca",161,4,0,2,2,0,2,6,50,4,7,1,6,3,7,2,0
"2861","Zeki Çelik",593,23,9,12,10,1,15,20,NA,5,14,4,10,9,32,14,0
"2862","Zouhair Feddal",349,4,2,1,3,0,3,4,NA,1,9,9,0,4,8,25,0
